"id","municipality_name","entitled_to_vote","votes_cast","turnout","valid_votes","yes","no","yes_percentage"
75601010001,"Aeugst am Albis",1374,861,62.7,854,415,439,48.6
75601010002,"Affoltern am Albis",7008,3814,54.4,3783,1947,1836,51.5
75601010003,"Bonstetten",3570,2283,63.9,2264,1135,1129,50.1
75601010004,"Hausen am Albis",2407,1492,62,1478,699,779,47.3
75601010005,"Hedingen",2449,1609,65.7,1594,732,862,45.9
75601010006,"Kappel am Albis",659,408,61.9,402,234,168,58.2
75601010007,"Knonau",1333,821,61.6,812,429,383,52.8
75601010008,"Maschwanden",465,277,59.6,276,147,129,53.3
75601010009,"Mettmenstetten",3085,1975,64,1955,993,962,50.8
75601010010,"Obfelden",3147,1884,59.9,1870,1047,823,56
75601010011,"Ottenbach",1830,1202,65.7,1193,605,588,50.7
75601010012,"Rifferswil",698,466,66.8,465,213,252,45.8
75601010013,"Stallikon",2267,1479,65.2,1465,795,670,54.3
75601010014,"Wettswil am Albis",3250,2137,65.8,2125,1012,1113,47.6
75601020021,"Adlikon",448,306,68.3,301,217,84,72.1
75601020022,"Benken (ZH)",613,387,63.1,387,233,154,60.2
75601020023,"Berg am Irchel",460,337,73.3,336,216,120,64.3
75601020024,"Buch am Irchel",664,428,64.5,425,272,153,64
75601020025,"Dachsen",1317,877,66.6,867,451,416,52
75601020026,"Dorf",461,313,67.9,310,217,93,70
75601020027,"Feuerthalen",2221,1230,55.4,1211,698,513,57.6
75601020028,"Flaach",946,604,63.8,597,398,199,66.7
75601020029,"Flurlingen",982,659,67.1,651,314,337,48.2
75601020030,"Andelfingen",1478,997,67.5,984,503,481,51.1
75601020031,"Henggart",1579,1015,64.3,1009,564,445,55.9
75601020032,"Humlikon",362,249,68.8,249,155,94,62.2
75601020033,"Kleinandelfingen",1442,892,61.9,885,526,359,59.4
75601020034,"Laufen-Uhwiesen",1175,732,62.3,724,413,311,57
75601020035,"Marthalen",1466,943,64.3,935,599,336,64.1
75601020036,"Oberstammheim",892,564,63.2,560,312,248,55.7
75601020037,"Ossingen",986,604,61.3,596,343,253,57.6
75601020038,"Rheinau",915,597,65.2,588,282,306,48
75601020039,"Thalheim an der Thur",652,383,58.7,381,261,120,68.5
75601020040,"Trüllikon",760,456,60,451,296,155,65.6
75601020041,"Truttikon",335,247,73.7,244,157,87,64.3
75601020042,"Unterstammheim",627,429,68.4,425,218,207,51.3
75601020043,"Volken",203,128,63.1,127,73,54,57.5
75601020044,"Waltalingen",518,343,66.2,340,216,124,63.5
75601030051,"Bachenbülach",2486,1287,51.8,1275,701,574,55
75601030052,"Bassersdorf",7081,3815,53.9,3781,2112,1669,55.9
75601030053,"Bülach",11463,5946,51.9,5882,3285,2597,55.8
75601030054,"Dietlikon",4585,2633,57.4,2610,1378,1232,52.8
75601030055,"Eglisau",3045,1912,62.8,1895,995,900,52.5
75601030056,"Embrach",5475,2890,52.8,2868,1708,1160,59.6
75601030057,"Freienstein-Teufen",1627,1039,63.9,1025,563,462,54.9
75601030058,"Glattfelden",2925,1695,57.9,1677,1008,669,60.1
75601030059,"Hochfelden",1345,820,61,813,531,282,65.3
75601030060,"Höri",1504,740,49.2,739,511,228,69.1
75601030061,"Hüntwangen",731,471,64.4,470,283,187,60.2
75601030062,"Kloten",10754,5097,47.4,5053,2997,2056,59.3
75601030063,"Lufingen",1217,749,61.5,737,448,289,60.8
75601030064,"Nürensdorf",3805,2468,64.9,2451,1459,992,59.5
75601030065,"Oberembrach",826,506,61.3,504,331,173,65.7
75601030066,"Opfikon",7603,3448,45.4,3425,1992,1433,58.2
75601030067,"Rafz",2744,1722,62.8,1698,941,757,55.4
75601030068,"Rorbas",1548,761,49.2,748,429,319,57.4
75601030069,"Wallisellen",8844,4782,54.1,4747,2386,2361,50.3
75601030070,"Wasterkingen",431,288,66.8,285,179,106,62.8
75601030071,"Wil (ZH)",989,652,65.9,641,395,246,61.6
75601030072,"Winkel",3025,1894,62.6,1885,1095,790,58.1
75601040081,"Bachs",469,283,60.3,279,192,87,68.8
75601040082,"Boppelsen",893,576,64.5,572,316,256,55.2
75601040083,"Buchs (ZH)",3786,2009,53.1,1995,1191,804,59.7
75601040084,"Dällikon",2227,1182,53.1,1172,736,436,62.8
75601040085,"Dänikon",1154,665,57.6,662,420,242,63.4
75601040086,"Dielsdorf",3535,1900,53.7,1890,1103,787,58.4
75601040087,"Hüttikon",498,311,62.4,310,223,87,71.9
75601040088,"Neerach",2279,1417,62.2,1407,842,565,59.8
75601040089,"Niederglatt",2854,1519,53.2,1506,989,517,65.7
75601040090,"Niederhasli",5379,2840,52.8,2820,1756,1064,62.3
75601040091,"Niederweningen",1840,1124,61.1,1114,579,535,52
75601040092,"Oberglatt",3396,1542,45.4,1532,954,578,62.3
75601040093,"Oberweningen",1118,707,63.2,697,422,275,60.5
75601040094,"Otelfingen",1746,1005,57.6,993,532,461,53.6
75601040095,"Regensberg",320,230,71.9,228,106,122,46.5
75601040096,"Regensdorf",9390,4860,51.8,4830,2999,1831,62.1
75601040097,"Rümlang",4265,2096,49.1,2083,1377,706,66.1
75601040098,"Schleinikon",524,315,60.1,315,184,131,58.4
75601040099,"Schöfflisdorf",962,603,62.7,597,352,245,59
75601040100,"Stadel",1491,838,56.2,824,530,294,64.3
75601040101,"Steinmaur",2095,1263,60.3,1251,735,516,58.8
75601040102,"Weiach",757,435,57.5,429,289,140,67.4
75601050111,"Bäretswil",3583,2212,61.7,2202,1368,834,62.1
75601050112,"Bubikon",4907,2974,60.6,2958,1693,1265,57.2
75601050113,"Dürnten",4784,2820,58.9,2800,1685,1115,60.2
75601050114,"Fischenthal",1614,972,60.2,954,676,278,70.9
75601050115,"Gossau (ZH)",6821,3981,58.4,3940,2290,1650,58.1
75601050116,"Grüningen",2317,1407,60.7,1402,793,609,56.6
75601050117,"Hinwil",7447,4380,58.8,4342,2618,1724,60.3
75601050118,"Rüti (ZH)",7721,4132,53.5,4103,2232,1871,54.4
75601050119,"Seegräben",906,461,50.9,455,222,233,48.8
75601050120,"Wald (ZH)",5808,3100,53.4,3080,1746,1334,56.7
75601050121,"Wetzikon (ZH)",14823,7672,51.8,7594,4219,3375,55.6
75601060131,"Adliswil",10352,5833,56.3,5794,2857,2937,49.3
75601060132,"Hirzel",1457,878,60.3,868,417,451,48
75601060133,"Horgen",11632,6404,55.1,6339,2985,3354,47.1
75601060134,"Hütten",676,376,55.6,375,232,143,61.9
75601060135,"Kilchberg (ZH)",4716,3055,64.8,3023,1260,1763,41.7
75601060136,"Langnau am Albis",4540,2719,59.9,2694,1315,1379,48.8
75601060137,"Oberrieden",3481,2291,65.8,2266,946,1320,41.7
75601060138,"Richterswil",8522,5157,60.5,5109,2494,2615,48.8
75601060139,"Rüschlikon",3449,2177,63.1,2151,913,1238,42.4
75601060140,"Schönenberg (ZH)",1431,903,63.1,898,520,378,57.9
75601060141,"Thalwil",10991,6664,60.6,6644,2810,3834,42.3
75601060142,"Wädenswil",13660,8037,58.8,7948,3792,4156,47.7
75601070151,"Erlenbach (ZH)",3497,2278,65.1,2253,869,1384,38.6
75601070152,"Herrliberg",4101,2777,67.7,2752,1277,1475,46.4
75601070153,"Hombrechtikon",5445,3208,58.9,3185,1749,1436,54.9
75601070154,"Küsnacht (ZH)",9127,6024,66,5964,2542,3422,42.6
75601070155,"Männedorf",7012,4622,65.9,4577,1983,2594,43.3
75601070156,"Meilen",8632,5505,63.8,5449,2454,2995,45
75601070157,"Oetwil am See",2674,1364,51,1354,798,556,58.9
75601070158,"Stäfa",9571,6212,64.9,6148,2652,3496,43.1
75601070159,"Uetikon am See",3955,2557,64.7,2530,1134,1396,44.8
75601070160,"Zumikon",3360,2289,68.1,2270,907,1363,40
75601070161,"Zollikon",8276,5432,65.6,5379,2014,3365,37.4
75601080171,"Bauma",3014,1848,61.3,1838,1273,565,69.3
75601080172,"Fehraltorf",4221,2468,58.5,2451,1320,1131,53.9
75601080173,"Hittnau",2597,1609,62,1595,949,646,59.5
75601080174,"Illnau-Effretikon",10213,5823,57,5759,3155,2604,54.8
75601080175,"Kyburg",294,199,67.7,197,108,89,54.8
75601080176,"Lindau",3365,2098,62.3,2073,1222,851,58.9
75601080177,"Pfäffikon",7465,4560,61.1,4513,2378,2135,52.7
75601080178,"Russikon",2950,1883,63.8,1871,1068,803,57.1
75601080179,"Sternenberg",281,176,62.6,176,107,69,60.8
75601080180,"Weisslingen",2340,1507,64.4,1497,859,638,57.4
75601080181,"Wila",1389,834,60,828,581,247,70.2
75601080182,"Wildberg",721,483,67,479,290,189,60.5
75601090191,"Dübendorf",14720,7666,52.1,7603,4099,3504,53.9
75601090192,"Egg",5534,3382,61.1,3366,1710,1656,50.8
75601090193,"Fällanden",5199,2932,56.4,2906,1358,1548,46.7
75601090194,"Greifensee",3515,2143,61,2124,951,1173,44.8
75601090195,"Maur",6479,4205,64.9,4163,2005,2158,48.2
75601090196,"Mönchaltorf",2440,1528,62.6,1510,782,728,51.8
75601090197,"Schwerzenbach",3132,1758,56.1,1745,867,878,49.7
75601090198,"Uster",21268,12355,58.1,12217,5565,6652,45.6
75601090199,"Volketswil",11107,5975,53.8,5926,3507,2419,59.2
75601090200,"Wangen-Brüttisellen",4559,2396,52.6,2373,1367,1006,57.6
75601100211,"Altikon",474,313,66,312,187,125,59.9
75601100213,"Brütten",1544,1040,67.4,1027,544,483,53
75601100214,"Dägerlen",703,492,70,487,274,213,56.3
75601100215,"Dättlikon",542,367,67.7,362,178,184,49.2
75601100216,"Dinhard",1097,708,64.5,702,401,301,57.1
75601100217,"Elgg",2776,1708,61.5,1690,953,737,56.4
75601100218,"Ellikon an der Thur",643,366,56.9,362,218,144,60.2
75601100219,"Elsau",2367,1512,63.9,1497,825,672,55.1
75601100220,"Hagenbuch",817,474,58,468,331,137,70.7
75601100221,"Hettlingen",2136,1440,67.4,1429,743,686,52
75601100222,"Hofstetten (ZH)",356,268,75.3,264,192,72,72.7
75601100223,"Neftenbach",3856,2289,59.4,2271,1252,1019,55.1
75601100224,"Pfungen",2106,1142,54.2,1135,658,477,58
75601100225,"Rickenbach (ZH)",1783,1132,63.5,1120,616,504,55
75601100226,"Schlatt (ZH)",514,356,69.3,345,211,134,61.2
75601100227,"Seuzach",5264,3188,60.6,3161,1791,1370,56.7
75601100228,"Turbenthal",2866,1583,55.2,1568,1012,556,64.5
75601100230,"Winterthur",68065,39132,57.5,38659,15966,22693,41.3
75601100231,"Zell (ZH)",3628,1966,54.2,1956,1159,797,59.3
75601110241,"Aesch (ZH)",814,591,72.6,587,304,283,51.8
75601110242,"Birmensdorf (ZH)",3905,2406,61.6,2390,1238,1152,51.8
75601110243,"Dietikon",12402,5792,46.7,5745,3155,2590,54.9
75601110244,"Geroldswil",3034,1656,54.6,1643,984,659,59.9
75601110245,"Oberengstringen",3917,2065,52.7,2051,1060,991,51.7
75601110246,"Oetwil an der Limmat",1685,1044,62,1040,585,455,56.3
75601110247,"Schlieren",8008,3506,43.8,3478,1851,1627,53.2
75601110248,"Uitikon",2787,1900,68.2,1882,878,1004,46.7
75601110249,"Unterengstringen",2297,1377,59.9,1367,802,565,58.7
75601110250,"Urdorf",6118,3387,55.4,3351,1822,1529,54.4
75601110251,"Weiningen (ZH)",2641,1515,57.4,1499,894,605,59.6
75601120261,"Zürich",230463,125799,54.6,124554,41586,82968,33.4
75601100298,"Wiesendangen",4462,2890,64.8,2866,1595,1271,55.7
75602430301,"Aarberg",3188,1730,54.3,1714,909,805,53
75602430302,"Bargen (BE)",759,413,54.4,409,237,172,57.9
75602430303,"Grossaffoltern",2277,1266,55.6,1254,676,578,53.9
75602430304,"Kallnach",1485,781,52.6,775,491,284,63.4
75602430305,"Kappelen",962,508,52.8,505,323,182,64
75602430306,"Lyss",9938,5111,51.4,5054,2637,2417,52.2
75602460307,"Meikirch",1957,1231,62.9,1205,550,655,45.6
75602430309,"Radelfingen",969,543,56,535,310,225,57.9
75602430310,"Rapperswil (BE)",1890,996,52.7,986,572,414,58
75602430311,"Schüpfen",2803,1497,53.4,1486,726,760,48.9
75602430312,"Seedorf (BE)",2355,1314,55.8,1301,796,505,61.2
75602440321,"Aarwangen",3004,1625,54.1,1614,944,670,58.5
75602440322,"Auswil",394,206,52.3,205,152,53,74.1
75602440323,"Bannwil",526,310,58.9,306,195,111,63.7
75602440324,"Bleienbach",545,316,58,313,227,86,72.5
75602440325,"Busswil bei Melchnau",158,87,55.1,85,61,24,71.8
75602440326,"Gondiswil",605,324,53.6,321,231,90,72
75602440329,"Langenthal",10363,5325,51.4,5284,2498,2786,47.3
75602440331,"Lotzwil",1675,928,55.4,926,543,383,58.6
75602440332,"Madiswil",2469,1347,54.6,1308,818,490,62.5
75602440333,"Melchnau",1113,563,50.6,555,324,231,58.4
75602440334,"Obersteckholz",334,183,54.8,180,121,59,67.2
75602440335,"Oeschenbach",205,93,45.4,92,66,26,71.7
75602440336,"Reisiswil",154,70,45.5,70,56,14,80
75602440337,"Roggwil (BE)",2734,1417,51.8,1403,821,582,58.5
75602440338,"Rohrbach",1147,550,48,542,380,162,70.1
75602440339,"Rohrbachgraben",325,172,52.9,169,129,40,76.3
75602440340,"Rütschelen",438,253,57.8,252,177,75,70.2
75602440341,"Schwarzhäusern",396,226,57.1,223,143,80,64.1
75602440342,"Thunstetten",2120,1090,51.4,1077,709,368,65.8
75602440344,"Ursenbach",716,336,46.9,333,225,108,67.6
75602440345,"Wynau",1084,554,51.1,545,360,185,66.1
75602460351,"Bern",86862,50072,57.6,49390,13680,35710,27.7
75602460352,"Bolligen",4712,3229,68.5,3188,1369,1819,42.9
75602460353,"Bremgarten bei Bern",3219,2147,66.7,2123,755,1368,35.6
75602460354,"Kirchlindach",2277,1452,63.8,1440,599,841,41.6
75602460355,"Köniz",27852,16734,60.1,16497,6700,9797,40.6
75602460356,"Muri bei Bern",9491,6128,64.6,6043,2424,3619,40.1
75602460357,"Oberbalm",698,392,56.2,390,265,125,67.9
75602460358,"Stettlen",2155,1277,59.3,1264,566,698,44.8
75602460359,"Vechigen",3847,2445,63.6,2421,1185,1236,48.9
75602460360,"Wohlen bei Bern",6873,4465,65,4409,1772,2637,40.2
75602460361,"Zollikofen",6876,4183,60.8,4134,1950,2184,47.2
75602460362,"Ittigen",7532,4116,54.6,4077,1889,2188,46.3
75602460363,"Ostermundigen",10126,5072,50.1,5020,2408,2612,48
75602420371,"Biel/Bienne",31732,14736,46.4,14578,6421,8157,44
75602420372,"Evilard",1776,1100,61.9,1085,397,688,36.6
75602430381,"Arch",1144,590,51.6,586,403,183,68.8
75602430382,"Büetigen",606,336,55.4,334,224,110,67.1
75602430383,"Büren an der Aare",2444,1262,51.6,1250,709,541,56.7
75602430385,"Diessbach bei Büren",674,368,54.6,363,221,142,60.9
75602430386,"Dotzigen",1074,585,54.5,583,362,221,62.1
75602420387,"Lengnau (BE)",3192,1587,49.7,1573,1007,566,64
75602430388,"Leuzigen",961,487,50.7,484,336,148,69.4
75602430389,"Meienried",NA,NA,NA,NA,NA,NA,NA
75602420390,"Meinisberg",953,527,55.3,524,337,187,64.3
75602430391,"Oberwil bei Büren",629,321,51,319,196,123,61.4
75602420392,"Pieterlen",2449,1106,45.2,1090,726,364,66.6
75602430393,"Rüti bei Büren",653,323,49.5,320,204,116,63.8
75602430394,"Wengi",432,231,53.5,225,147,78,65.3
75602450401,"Aefligen",828,450,54.3,438,305,133,69.6
75602450402,"Alchenstorf",453,254,56.1,252,170,82,67.5
75602460403,"Bäriswil",808,500,61.9,498,281,217,56.4
75602450404,"Burgdorf",11545,6047,52.4,5981,2406,3575,40.2
75602450405,"Ersigen",1578,920,58.3,911,593,318,65.1
75602450406,"Hasle bei Burgdorf",2549,1145,44.9,1131,705,426,62.3
75602450407,"Heimiswil",1234,642,52,633,409,224,64.6
75602450408,"Hellsau",NA,NA,NA,NA,NA,NA,NA
75602450409,"Hindelbank",1726,877,50.8,866,482,384,55.7
75602450410,"Höchstetten",360,186,51.7,186,132,54,71
75602450411,"Kernenried",338,178,52.7,176,117,59,66.5
75602450412,"Kirchberg (BE)",4180,2314,55.4,2298,1146,1152,49.9
75602450413,"Koppigen",1575,841,53.4,834,485,349,58.2
75602450414,"Krauchthal",1830,998,54.5,981,635,346,64.7
75602450415,"Lyssach",1092,538,49.3,526,310,216,58.9
75602450416,"Mötschwil",236,125,53,122,86,36,70.5
75602450417,"Niederösch",NA,NA,NA,NA,NA,NA,NA
75602450418,"Oberburg",2054,1012,49.3,1004,625,379,62.3
75602450419,"Oberösch",NA,NA,NA,NA,NA,NA,NA
75602450420,"Rüdtligen-Alchenflüh",1539,669,43.5,660,421,239,63.8
75602450421,"Rumendingen",71,48,67.6,47,29,18,61.7
75602450422,"Rüti bei Lyssach",NA,NA,NA,NA,NA,NA,NA
75602450423,"Willadingen",173,113,65.3,113,80,33,70.8
75602450424,"Wynigen",1629,868,53.3,861,520,341,60.4
75602410431,"Corgémont",1120,607,54.2,593,338,255,57
75602410432,"Cormoret",378,198,52.4,197,93,104,47.2
75602410433,"Cortébert",495,234,47.3,228,141,87,61.8
75602410434,"Courtelary",896,501,55.9,493,256,237,51.9
75602410435,"La Ferrière",406,185,45.6,181,93,88,51.4
75602410436,"La Heutte",361,180,49.9,179,106,73,59.2
75602410437,"Mont-Tramelan",110,54,49.1,53,32,21,60.4
75602410438,"Orvin",875,448,51.2,441,247,194,56
75602410439,"Péry",969,471,48.6,466,250,216,53.6
75602410441,"Renan (BE)",664,336,50.6,329,110,219,33.4
75602410442,"Romont (BE)",151,81,53.6,80,51,29,63.8
75602410443,"Saint-Imier",2970,1372,46.2,1357,647,710,47.7
75602410444,"Sonceboz-Sombeval",1211,565,46.7,547,295,252,53.9
75602410445,"Sonvilier",854,384,45,369,200,169,54.2
75602410446,"Tramelan",3122,1946,62.3,1910,940,970,49.2
75602410448,"Villeret",638,324,50.8,322,163,159,50.6
75602410449,"Sauge",591,294,49.7,281,153,128,54.4
75602430491,"Brüttelen",413,235,56.9,229,142,87,62
75602430492,"Erlach",967,541,55.9,530,229,301,43.2
75602430493,"Finsterhennen",314,175,55.7,170,109,61,64.1
75602430494,"Gals",525,277,52.8,274,141,133,51.5
75602430495,"Gampelen",594,314,52.9,314,169,145,53.8
75602430496,"Ins",2241,1351,60.3,1334,683,651,51.2
75602430497,"Lüscherz",412,185,44.9,185,121,64,65.4
75602430498,"Müntschemier",780,479,61.4,475,314,161,66.1
75602430499,"Siselen",457,246,53.8,244,145,99,59.4
75602430500,"Treiten",331,194,58.6,194,116,78,59.8
75602430501,"Tschugg",310,180,58.1,177,78,99,44.1
75602430502,"Vinelz",643,375,58.3,371,187,184,50.4
75602430532,"Bangerten",130,86,66.2,86,57,29,66.3
75602450533,"Bätterkinden",2411,1291,53.5,1258,625,633,49.7
75602460535,"Deisswil bei Münchenbuchsee",NA,NA,NA,NA,NA,NA,NA
75602460536,"Diemerswil",143,89,62.2,89,45,44,50.6
75602460538,"Fraubrunnen",3744,2141,57.2,2109,1077,1032,51.1
75602460540,"Jegenstorf",4108,2455,59.8,2437,1131,1306,46.4
75602460541,"Iffwil",336,194,57.7,193,112,81,58
75602460543,"Mattstetten",471,275,58.4,267,150,117,56.2
75602460544,"Moosseedorf",2582,1395,54,1390,718,672,51.7
75602460546,"Münchenbuchsee",6920,3921,56.7,3874,1740,2134,44.9
75602460551,"Urtenen-Schönbühl",4250,2118,49.8,2104,1117,987,53.1
75602450552,"Utzenstorf",3114,1761,56.6,1751,956,795,54.6
75602460553,"Wiggiswil",144,92,63.9,92,59,33,64.1
75602450554,"Wiler bei Utzenstorf",662,328,49.5,324,176,148,54.3
75602450556,"Zielebach",270,135,50,135,95,40,70.4
75602460557,"Zuzwil (BE)",450,295,65.6,294,148,146,50.3
75602490561,"Adelboden",2707,1787,66,1760,1263,497,71.8
75602490562,"Aeschi bei Spiez",1700,956,56.2,952,580,372,60.9
75602490563,"Frutigen",5176,2927,56.5,2873,1989,884,69.2
75602490564,"Kandergrund",625,310,49.6,310,232,78,74.8
75602490565,"Kandersteg",892,487,54.6,485,264,221,54.4
75602490566,"Krattigen",860,486,56.5,479,286,193,59.7
75602490567,"Reichenbach im Kandertal",2753,1452,52.7,1431,1020,411,71.3
75602500571,"Beatenberg",874,496,56.8,484,294,190,60.7
75602500572,"Bönigen",1927,953,49.5,950,549,401,57.8
75602500573,"Brienz (BE)",2303,1244,54,1236,739,497,59.8
75602500574,"Brienzwiler",389,207,53.2,206,149,57,72.3
75602500575,"Därligen",309,168,54.4,168,100,68,59.5
75602500576,"Grindelwald",2703,1266,46.8,1230,838,392,68.1
75602500577,"Gsteigwiler",334,181,54.2,179,101,78,56.4
75602500578,"Gündlischwand",236,121,51.3,116,87,29,75
75602500579,"Habkern",480,238,49.6,237,191,46,80.6
75602500580,"Hofstetten bei Brienz",422,243,57.6,242,153,89,63.2
75602500581,"Interlaken",3612,2253,62.4,2222,1170,1052,52.7
75602500582,"Iseltwald",325,170,52.3,170,109,61,64.1
75602500584,"Lauterbrunnen",1668,795,47.7,785,451,334,57.5
75602500585,"Leissigen",743,397,53.4,393,242,151,61.6
75602500586,"Lütschental",203,97,47.8,96,77,19,80.2
75602500587,"Matten bei Interlaken",2693,1361,50.5,1341,783,558,58.4
75602500588,"Niederried bei Interlaken",254,130,51.2,130,79,51,60.8
75602500589,"Oberried am Brienzersee",373,179,48,179,102,77,57
75602500590,"Ringgenberg (BE)",2012,961,47.8,952,578,374,60.7
75602500591,"Saxeten",89,49,55.1,49,36,13,73.5
75602500592,"Schwanden bei Brienz",485,260,53.6,255,118,137,46.3
75602500593,"Unterseen",4075,2251,55.2,2213,1194,1019,54
75602500594,"Wilderswil",1880,938,49.9,928,581,347,62.6
75602460602,"Arni (BE)",777,399,51.4,395,270,125,68.4
75602460603,"Biglen",1340,669,49.9,663,357,306,53.8
75602460605,"Bowil",1096,529,48.3,523,358,165,68.5
75602460606,"Brenzikofen",419,241,57.5,240,176,64,73.3
75602460607,"Freimettigen",348,201,57.8,199,133,66,66.8
75602460608,"Grosshöchstetten",2595,1558,60,1511,770,741,51
75602460609,"Häutligen",202,111,55,111,89,22,80.2
75602460610,"Herbligen",443,241,54.4,236,161,75,68.2
75602460611,"Kiesen",689,386,56,380,211,169,55.5
75602460612,"Konolfingen",3761,2109,56.1,2085,1121,964,53.8
75602460613,"Landiswil",538,269,50,268,204,64,76.1
75602460614,"Linden",1043,578,55.4,573,433,140,75.6
75602460615,"Mirchel",453,228,50.3,225,166,59,73.8
75602460616,"Münsingen",8645,5138,59.4,5077,2334,2743,46
75602460617,"Niederhünigen",479,271,56.6,268,144,124,53.7
75602460619,"Oberdiessbach",2653,1478,55.7,1459,896,563,61.4
75602460620,"Oberthal",626,303,48.4,302,220,82,72.8
75602460622,"Oppligen",501,248,49.5,248,147,101,59.3
75602460623,"Rubigen",2219,1248,56.2,1233,570,663,46.2
75602460624,"Schlosswil",510,283,55.5,282,160,122,56.7
75602460625,"Tägertschi",302,184,60.9,184,115,69,62.5
75602460626,"Walkringen",1447,736,50.9,732,484,248,66.1
75602460627,"Worb",8241,4659,56.5,4601,2210,2391,48
75602460628,"Zäziwil",1254,664,53,657,398,259,60.6
75602460629,"Oberhünigen",231,136,58.9,136,99,37,72.8
75602460630,"Allmendingen",414,254,61.4,250,126,124,50.4
75602460632,"Wichtrach",3115,1685,54.1,1665,916,749,55
75602460661,"Clavaleyres",NA,NA,NA,NA,NA,NA,NA
75602460662,"Ferenbalm",969,587,60.6,580,360,220,62.1
75602460663,"Frauenkappelen",955,570,59.7,559,294,265,52.6
75602460664,"Golaten",243,148,60.9,142,105,37,73.9
75602460665,"Gurbrü",193,115,59.6,112,78,34,69.6
75602460666,"Kriechenwil",352,199,56.5,198,125,73,63.1
75602460667,"Laupen",2107,1130,53.6,1120,511,609,45.6
75602460668,"Mühleberg",2160,1282,59.4,1268,729,539,57.5
75602460669,"Münchenwiler",377,202,53.6,201,122,79,60.7
75602460670,"Neuenegg",3663,2063,56.3,2042,1186,856,58.1
75602460671,"Wileroltigen",279,139,49.8,139,94,45,67.6
75602410681,"Belprahon",248,144,58.1,141,71,70,50.4
75602410682,"Bévilard",1181,591,50,582,337,245,57.9
75602410683,"Champoz",127,85,66.9,80,47,33,58.8
75602410684,"Châtelat",80,59,73.8,59,41,18,69.5
75602410687,"Corcelles (BE)",167,92,55.1,90,62,28,68.9
75602410690,"Court",1028,514,50,507,297,210,58.6
75602410691,"Crémines",405,191,47.2,186,96,90,51.6
75602410692,"Eschert",258,117,45.3,116,67,49,57.8
75602410694,"Grandval",285,143,50.2,143,87,56,60.8
75602410696,"Loveresse",240,170,70.8,170,106,64,62.4
75602410697,"Malleray",1300,647,49.8,637,356,281,55.9
75602410699,"Monible",30,22,73.3,22,11,11,50
75602410700,"Moutier",4743,2367,49.9,2329,1088,1241,46.7
75602410701,"Perrefitte",320,192,60,187,125,62,66.8
75602410702,"Pontenet",158,106,67.1,103,38,65,36.9
75602410703,"Reconvilier",1491,892,59.8,877,503,374,57.4
75602410704,"Roches (BE)",168,90,53.6,90,62,28,68.9
75602410706,"Saicourt",452,285,63.1,281,180,101,64.1
75602410707,"Saules (BE)",121,82,67.8,82,58,24,70.7
75602410708,"Schelten",56,27,48.2,27,12,15,44.4
75602410709,"Seehof",64,33,51.6,32,25,7,78.1
75602410710,"Sornetan",104,62,59.6,62,25,37,40.3
75602410711,"Sorvilier",198,110,55.6,110,53,57,48.2
75602410712,"Souboz",89,55,61.8,54,30,24,55.6
75602410713,"Tavannes",2252,1207,53.6,1191,605,586,50.8
75602410715,"Rebévelier",34,26,76.5,26,17,9,65.4
75602410723,"La Neuveville",2583,1482,57.4,1454,541,913,37.2
75602410724,"Nods",559,287,51.3,286,132,154,46.2
75602410726,"Plateau de Diesse",1510,778,51.5,759,338,421,44.5
75602420731,"Aegerten",1309,691,52.8,683,403,280,59
75602420732,"Bellmund",1181,715,60.5,704,357,347,50.7
75602420733,"Brügg",2868,1368,47.7,1350,784,566,58.1
75602430734,"Bühl",337,177,52.5,177,114,63,64.4
75602430735,"Epsach",262,145,55.3,145,97,48,66.9
75602430736,"Hagneck",329,191,58.1,188,121,67,64.4
75602430737,"Hermrigen",214,112,52.3,111,79,32,71.2
75602430738,"Jens",536,315,58.8,308,161,147,52.3
75602420739,"Ipsach",2951,1636,55.4,1621,809,812,49.9
75602420740,"Ligerz",427,284,66.5,279,113,166,40.5
75602430741,"Merzligen",319,183,57.4,181,94,87,51.9
75602420742,"Mörigen",689,430,62.4,420,250,170,59.5
75602420743,"Nidau",4547,2189,48.1,2174,1029,1145,47.3
75602420744,"Orpund",1906,974,51.1,964,589,375,61.1
75602420745,"Port",2558,1424,55.7,1410,780,630,55.3
75602420746,"Safnern",1419,782,55.1,777,469,308,60.4
75602420747,"Scheuren",356,187,52.5,182,115,67,63.2
75602420748,"Schwadernau",493,255,51.7,255,153,102,60
75602430749,"Studen (BE)",2119,1049,49.5,1041,630,411,60.5
75602420750,"Sutz-Lattrigen",1031,553,53.6,546,293,253,53.7
75602430751,"Täuffelen",2045,1134,55.5,1125,627,498,55.7
75602430754,"Walperswil",748,392,52.4,391,243,148,62.1
75602430755,"Worben",1699,937,55.2,923,648,275,70.2
75602420756,"Twann-Tüscherz",906,549,60.6,545,260,285,47.7
75602490761,"Därstetten",652,340,52.1,334,263,71,78.7
75602490762,"Diemtigen",1685,856,50.8,847,671,176,79.2
75602490763,"Erlenbach im Simmental",1311,690,52.6,683,475,208,69.5
75602490766,"Oberwil im Simmental",694,384,55.3,381,304,77,79.8
75602470767,"Reutigen",765,457,59.7,456,306,150,67.1
75602490768,"Spiez",9660,5641,58.4,5579,2909,2670,52.1
75602490769,"Wimmis",1864,975,52.3,967,625,342,64.6
75602470770,"Stocken-Höfen",776,375,48.3,366,252,114,68.9
75602500782,"Guttannen",231,109,47.2,107,69,38,64.5
75602500783,"Hasliberg",865,414,47.9,413,253,160,61.3
75602500784,"Innertkirchen",856,395,46.1,393,279,114,71
75602500785,"Meiringen",3290,1665,50.6,1658,911,747,54.9
75602500786,"Schattenhalb",432,206,47.7,203,134,69,66
75602480791,"Boltigen",1106,553,50,551,419,132,76
75602480792,"Lenk",1830,977,53.4,959,649,310,67.7
75602480793,"St. Stephan",1051,674,64.1,670,529,141,79
75602480794,"Zweisimmen",2320,1162,50.1,1152,730,422,63.4
75602480841,"Gsteig",726,320,44.1,320,220,100,68.8
75602480842,"Lauenen",627,333,53.1,331,241,90,72.8
75602480843,"Saanen",4357,2421,55.6,2396,1469,927,61.3
75602460852,"Guggisberg",1321,593,44.9,587,438,149,74.6
75602460853,"Rüschegg",1393,618,44.4,615,412,203,67
75602460855,"Schwarzenburg",5476,2978,54.4,2944,1679,1265,57
75602460861,"Belp",8304,4746,57.2,4683,2547,2136,54.4
75602470863,"Burgistein",836,439,52.5,435,284,151,65.3
75602460865,"Gelterfingen",217,123,56.7,122,91,31,74.6
75602460866,"Gerzensee",899,519,57.7,510,304,206,59.6
75602470867,"Gurzelen",602,344,57.1,341,225,116,66
75602460868,"Jaberg",NA,NA,NA,NA,NA,NA,NA
75602460869,"Kaufdorf",751,490,65.2,477,222,255,46.5
75602460870,"Kehrsatz",2740,1653,60.3,1626,707,919,43.5
75602460872,"Kirchdorf (BE)",1124,644,57.3,638,370,268,58
75602460873,"Kirchenthurnen",223,121,54.3,120,89,31,74.2
75602460874,"Lohnstorf",163,97,59.5,95,58,37,61.1
75602460875,"Mühledorf (BE)",182,110,60.4,107,57,50,53.3
75602460876,"Mühlethurnen",1092,678,62.1,675,298,377,44.1
75602460877,"Niedermuhlern",NA,NA,NA,NA,NA,NA,NA
75602460878,"Noflen",NA,NA,NA,NA,NA,NA,NA
75602460879,"Riggisberg",1917,986,51.4,970,619,351,63.8
75602460880,"Rüeggisberg",1505,758,50.4,749,509,240,68
75602460881,"Rümligen",355,222,62.5,217,135,82,62.2
75602470883,"Seftigen",1704,943,55.3,937,576,361,61.5
75602460884,"Toffen",1926,1147,59.6,1097,619,478,56.4
75602470885,"Uttigen",1436,874,60.9,869,509,360,58.6
75602470886,"Wattenwil",2187,1091,49.9,1070,696,374,65
75602460888,"Wald (BE)",1352,786,58.1,772,448,324,58
75602450901,"Eggiwil",2001,917,45.8,897,694,203,77.4
75602450902,"Langnau im Emmental",7219,3619,50.1,3560,1896,1664,53.3
75602450903,"Lauperswil",2160,997,46.2,987,690,297,69.9
75602450904,"Röthenbach im Emmental",1008,475,47.1,473,391,82,82.7
75602450905,"Rüderswil",1915,897,46.8,889,602,287,67.7
75602450906,"Schangnau",762,403,52.9,395,333,62,84.3
75602450907,"Signau",2181,1042,47.8,1027,725,302,70.6
75602450908,"Trub",1247,528,42.3,525,386,139,73.5
75602450909,"Trubschachen",1105,540,48.9,532,307,225,57.7
75602470921,"Amsoldingen",632,360,57,355,228,127,64.2
75602470922,"Blumenstein",964,519,53.8,511,345,166,67.5
75602470923,"Buchholterberg",1249,697,55.8,694,532,162,76.7
75602470924,"Eriz",433,236,54.5,236,192,44,81.4
75602470925,"Fahrni",633,352,55.6,349,251,98,71.9
75602470927,"Heiligenschwendi",511,320,62.6,311,185,126,59.5
75602470928,"Heimberg",4944,2542,51.4,2517,1578,939,62.7
75602470929,"Hilterfingen",3133,1911,61,1875,875,1000,46.7
75602470931,"Homberg",383,228,59.5,224,171,53,76.3
75602470932,"Horrenbach-Buchen",200,125,62.5,125,117,8,93.6
75602470934,"Oberhofen am Thunersee",1870,1175,62.8,1148,603,545,52.5
75602470935,"Oberlangenegg",382,200,52.4,196,162,34,82.7
75602470936,"Pohlern",202,100,49.5,100,80,20,80
75602470937,"Schwendibach",199,126,63.3,123,87,36,70.7
75602470938,"Sigriswil",3778,2397,63.4,2381,1667,714,70
75602470939,"Steffisburg",11813,6624,56.1,6540,3535,3005,54.1
75602470940,"Teuffenthal (BE)",140,80,57.1,79,67,12,84.8
75602470941,"Thierachern",1837,1026,55.9,1018,648,370,63.7
75602470942,"Thun",32252,17268,53.5,17043,8789,8254,51.6
75602470943,"Uebeschi",498,280,56.2,277,211,66,76.2
75602470944,"Uetendorf",4681,2635,56.3,2593,1600,993,61.7
75602470945,"Unterlangenegg",743,350,47.1,349,254,95,72.8
75602470946,"Wachseldorn",190,98,51.6,98,73,25,74.5
75602470947,"Zwieselberg",209,114,54.5,114,69,45,60.5
75602470948,"Forst-Längenbühl",587,336,57.2,328,218,110,66.5
75602450951,"Affoltern im Emmental",950,489,51.5,477,332,145,69.6
75602450952,"Dürrenroth",841,430,51.1,424,318,106,75
75602440953,"Eriswil",1105,486,44,482,324,158,67.2
75602440954,"Huttwil",3543,1808,51,1686,1024,662,60.7
75602450955,"Lützelflüh",3227,1637,50.7,1624,1051,573,64.7
75602450956,"Rüegsau",2523,1421,56.3,1382,878,504,63.5
75602450957,"Sumiswald",4097,1933,47.2,1917,1201,716,62.6
75602450958,"Trachselwald",782,392,50.1,390,275,115,70.5
75602440959,"Walterswil (BE)",441,221,50.1,221,174,47,78.7
75602440960,"Wyssachen",952,487,51.2,482,367,115,76.1
75602440971,"Attiswil",1060,597,56.3,584,382,202,65.4
75602440972,"Berken",40,27,67.5,26,23,3,88.5
75602440973,"Bettenhausen",568,356,62.7,352,239,113,67.9
75602440975,"Farnern",167,83,49.7,81,56,25,69.1
75602440976,"Graben",241,132,54.8,131,97,34,74
75602440977,"Heimenhausen",805,444,55.2,439,291,148,66.3
75602440978,"Hermiswil",71,46,64.8,44,23,21,52.3
75602440979,"Herzogenbuchsee",4880,2511,51.5,2488,1205,1283,48.4
75602440980,"Inkwil",514,285,55.4,285,185,100,64.9
75602440981,"Niederbipp",2909,1429,49.1,1421,955,466,67.2
75602440982,"Niederönz",1162,707,60.8,698,397,301,56.9
75602440983,"Oberbipp",1175,620,52.8,616,371,245,60.2
75602440985,"Ochlenberg",476,275,57.8,274,180,94,65.7
75602440987,"Rumisberg",383,247,64.5,247,175,72,70.9
75602440988,"Seeberg",1186,642,54.1,637,394,243,61.9
75602440989,"Thörigen",859,441,51.3,438,302,136,68.9
75602440990,"Walliswil bei Niederbipp",179,86,48,86,56,30,65.1
75602440991,"Walliswil bei Wangen",483,256,53,250,166,84,66.4
75602440992,"Wangen an der Aare",1572,880,56,879,534,345,60.8
75602440993,"Wangenried",325,178,54.8,178,120,58,67.4
75602440995,"Wiedlisbach",1615,799,49.5,789,505,284,64
75602440996,"Wolfisberg",152,88,57.9,88,58,30,65.9
75603161001,"Doppleschwand",526,299,56.8,294,216,78,73.5
75603161002,"Entlebuch",2477,1444,58.3,1423,1005,418,70.6
75603161004,"Flühli",1233,805,65.3,799,552,247,69.1
75603161005,"Hasle (LU)",1276,782,61.3,768,557,211,72.5
75603161007,"Romoos",514,337,65.6,333,232,101,69.7
75603161008,"Schüpfheim",2991,1898,63.5,1872,1133,739,60.5
75603161009,"Werthenstein",1370,854,62.3,837,624,213,74.6
75603161010,"Escholzmatt-Marbach",3267,1929,59,1884,1279,605,67.9
75603131021,"Aesch (LU)",743,452,60.8,448,305,143,68.1
75603131022,"Altwis",275,161,58.5,159,103,56,64.8
75603131023,"Ballwil",1847,1135,61.5,1117,683,434,61.1
75603131024,"Emmen",16344,8190,50.1,8105,4741,3364,58.5
75603131025,"Ermensee",592,390,65.9,388,223,165,57.5
75603131026,"Eschenbach (LU)",2518,1660,65.9,1630,934,696,57.3
75603131030,"Hitzkirch",3351,1976,59,1940,1130,810,58.2
75603131031,"Hochdorf",5892,3220,54.7,3193,1585,1608,49.6
75603131032,"Hohenrain",1763,1097,62.2,1083,699,384,64.5
75603131033,"Inwil",1663,997,60,989,621,368,62.8
75603131037,"Rain",1805,1091,60.4,1076,611,465,56.8
75603131039,"Römerswil",1201,776,64.6,770,487,283,63.2
75603131040,"Rothenburg",5215,3373,64.7,3321,1742,1579,52.5
75603131041,"Schongau",700,406,58,404,272,132,67.3
75603121051,"Adligenswil",3846,2437,63.4,2409,1099,1310,45.6
75603121052,"Buchrain",3947,2259,57.2,2203,1113,1090,50.5
75603121053,"Dierikon",973,506,52,496,293,203,59.1
75603121054,"Ebikon",8259,4418,53.5,4338,2335,2003,53.8
75603121055,"Gisikon",783,458,58.5,444,276,168,62.2
75603121056,"Greppen",648,404,62.3,401,208,193,51.9
75603121057,"Honau",258,157,60.9,154,82,72,53.2
75603121058,"Horw",9358,5823,62.2,5722,2829,2893,49.4
75603121059,"Kriens",18533,11232,60.6,11084,5740,5344,51.8
75603111061,"Luzern",52994,28175,53.2,27659,10970,16689,39.7
75603121062,"Malters",4859,2869,59,2831,1599,1232,56.5
75603121063,"Meggen",4859,3228,66.4,3190,1389,1801,43.5
75603121064,"Meierskappel",912,568,62.3,556,332,224,59.7
75603121065,"Root",2754,1407,51.1,1394,818,576,58.7
75603121066,"Schwarzenberg",1245,785,63.1,775,490,285,63.2
75603121067,"Udligenswil",1547,1025,66.3,1002,556,446,55.5
75603121068,"Vitznau",807,526,65.2,522,303,219,58
75603121069,"Weggis",2851,1839,64.5,1813,974,839,53.7
75603141081,"Beromünster",4182,2475,59.2,2428,1394,1034,57.4
75603141082,"Büron",1315,722,54.9,709,455,254,64.2
75603141083,"Buttisholz",2157,1262,58.5,1234,748,486,60.6
75603141084,"Eich",1298,831,64,813,448,365,55.1
75603141085,"Geuensee",1605,875,54.5,865,541,324,62.5
75603141086,"Grosswangen",2069,1479,71.5,1459,885,574,60.7
75603141088,"Hildisrieden",1483,982,66.2,976,492,484,50.4
75603141089,"Knutwil",1425,839,58.9,816,483,333,59.2
75603141091,"Mauensee",869,514,59.1,508,270,238,53.1
75603141093,"Neuenkirch",4437,2603,58.7,2566,1437,1129,56
75603141094,"Nottwil",2385,1458,61.1,1426,782,644,54.8
75603141095,"Oberkirch",2656,1597,60.1,1569,785,784,50
75603141097,"Rickenbach (LU)",1977,1175,59.4,1163,775,388,66.6
75603141098,"Ruswil",4950,2878,58.1,2820,1689,1131,59.9
75603141099,"Schenkon",2104,1306,62.1,1282,685,597,53.4
75603141100,"Schlierbach",521,313,60.1,304,184,120,60.5
75603141102,"Sempach",2958,1884,63.7,1865,827,1038,44.3
75603141103,"Sursee",6443,3779,58.7,3689,1682,2007,45.6
75603141104,"Triengen",2745,1611,58.7,1586,969,617,61.1
75603161107,"Wolhusen",2866,1702,59.4,1685,1074,611,63.7
75603151121,"Alberswil",423,233,55.1,225,160,65,71.1
75603151122,"Altbüron",724,407,56.2,401,244,157,60.8
75603151123,"Altishofen",1014,514,50.7,501,261,240,52.1
75603151125,"Dagmersellen",3464,2025,58.5,1988,1220,768,61.4
75603151126,"Ebersecken",293,187,63.8,185,139,46,75.1
75603151127,"Egolzwil",995,557,56,550,317,233,57.6
75603151128,"Ettiswil",1835,1057,57.6,1034,624,410,60.3
75603151129,"Fischbach",480,278,57.9,277,194,83,70
75603151130,"Gettnau",675,365,54.1,360,247,113,68.6
75603151131,"Grossdietwil",604,333,55.1,322,192,130,59.6
75603151132,"Hergiswil bei Willisau",1353,793,58.6,790,552,238,69.9
75603151135,"Luthern",971,552,56.8,546,407,139,74.5
75603151136,"Menznau",2034,1201,59,1173,815,358,69.5
75603151137,"Nebikon",1486,887,59.7,873,538,335,61.6
75603151139,"Pfaffnau",1628,888,54.5,870,550,320,63.2
75603151140,"Reiden",4316,2372,55,2337,1449,888,62
75603151142,"Roggliswil",490,279,56.9,274,180,94,65.7
75603151143,"Schötz",2585,1384,53.5,1362,808,554,59.3
75603151145,"Ufhusen",623,366,58.7,363,265,98,73
75603151146,"Wauwil",1106,638,57.7,634,374,260,59
75603151147,"Wikon",990,552,55.8,550,349,201,63.5
75603151150,"Zell (LU)",1400,767,54.8,747,489,258,65.5
75603151151,"Willisau",5546,3291,59.3,3275,1853,1422,56.6
75604001201,"Altdorf (UR)",6449,3241,50.3,3209,1483,1726,46.2
75604001202,"Andermatt",946,523,55.3,520,263,257,50.6
75604001203,"Attinghausen",1138,605,53.2,592,378,214,63.9
75604001204,"Bauen",138,76,55.1,73,47,26,64.4
75604001205,"Bürglen (UR)",2973,1500,50.5,1486,947,539,63.7
75604001206,"Erstfeld",2579,1397,54.2,1379,825,554,59.8
75604001207,"Flüelen",1377,702,51,696,401,295,57.6
75604001208,"Göschenen",314,164,52.2,163,107,56,65.6
75604001209,"Gurtnellen",436,189,43.3,188,117,71,62.2
75604001210,"Hospental",157,66,42,66,33,33,50
75604001211,"Isenthal",389,189,48.6,188,103,85,54.8
75604001212,"Realp",131,77,58.8,74,35,39,47.3
75604001213,"Schattdorf",3767,1938,51.4,1932,1184,748,61.3
75604001214,"Seedorf (UR)",1283,638,49.7,631,401,230,63.5
75604001215,"Seelisberg",474,242,51.1,235,148,87,63
75604001216,"Silenen",1536,606,39.5,600,406,194,67.7
75604001217,"Sisikon",260,140,53.8,140,91,49,65
75604001218,"Spiringen",639,283,44.3,281,221,60,78.6
75604001219,"Unterschächen",537,287,53.4,284,241,43,84.9
75604001220,"Wassen",302,154,51,154,107,47,69.5
75605011301,"Einsiedeln",10386,6495,62.5,6460,4130,2330,63.9
75605021311,"Gersau",1518,912,60.1,910,523,387,57.5
75605031321,"Feusisberg",3131,1992,63.6,1981,1193,788,60.2
75605031322,"Freienbach",10068,6268,62.3,6225,3615,2610,58.1
75605031323,"Wollerau",4701,3012,64.1,2998,1692,1306,56.4
75605041331,"Küssnacht (SZ)",8203,5141,62.7,5103,2843,2260,55.7
75605051341,"Altendorf",4310,2706,62.8,2699,1731,968,64.1
75605051342,"Galgenen",3277,2002,61.1,1992,1361,631,68.3
75605051343,"Innerthal",149,99,66.4,98,75,23,76.5
75605051344,"Lachen",4901,2804,57.2,2777,1576,1201,56.8
75605051345,"Reichenburg",2201,1191,54.1,1187,842,345,70.9
75605051346,"Schübelbach",5325,2744,51.5,2725,1888,837,69.3
75605051347,"Tuggen",2158,1191,55.2,1188,859,329,72.3
75605051348,"Vorderthal",773,441,57.1,438,374,64,85.4
75605051349,"Wangen (SZ)",3362,1950,58,1942,1289,653,66.4
75605061361,"Alpthal",444,297,66.9,295,255,40,86.4
75605061362,"Arth",6853,3990,58.2,3971,2410,1561,60.7
75605061363,"Illgau",592,342,57.8,342,268,74,78.4
75605061364,"Ingenbohl",5906,3774,63.9,3745,2100,1645,56.1
75605061365,"Lauerz",755,509,67.4,506,356,150,70.4
75605061366,"Morschach",708,459,64.8,458,295,163,64.4
75605061367,"Muotathal",2617,1687,64.5,1680,1308,372,77.9
75605061368,"Oberiberg",682,457,67,456,307,149,67.3
75605061369,"Riemenstalden",58,38,65.5,38,27,11,71.1
75605061370,"Rothenthurm",1505,930,61.8,930,729,201,78.4
75605061371,"Sattel",1309,788,60.2,785,550,235,70.1
75605061372,"Schwyz",10156,6237,61.4,6204,3724,2480,60
75605061373,"Steinen",2395,1453,60.7,1446,942,504,65.1
75605061374,"Steinerberg",672,369,54.9,367,277,90,75.5
75605061375,"Unteriberg",1769,1099,62.1,1096,961,135,87.7
75606001401,"Alpnach",4053,2424,59.8,2333,1399,934,60
75606001402,"Engelberg",2587,1575,60.9,1537,885,652,57.6
75606001403,"Giswil",2603,1533,58.9,1497,922,575,61.6
75606001404,"Kerns",4308,2543,59,2486,1639,847,65.9
75606001405,"Lungern",1550,988,63.7,957,569,388,59.5
75606001406,"Sachseln",3492,2075,59.4,2040,1124,916,55.1
75606001407,"Sarnen",7253,4461,61.5,4345,2445,1900,56.3
75607001501,"Beckenried",2496,1566,62.7,1544,988,556,64
75607001502,"Buochs",3822,2240,58.6,2192,1288,904,58.8
75607001503,"Dallenwil",1346,813,60.4,792,536,256,67.7
75607001504,"Emmetten",974,542,55.6,534,371,163,69.5
75607001505,"Ennetbürgen",3441,2171,63.1,2131,1180,951,55.4
75607001506,"Ennetmoos",1521,921,60.6,907,601,306,66.3
75607001507,"Hergiswil (NW)",3924,2347,59.8,2300,1330,970,57.8
75607001508,"Oberdorf (NW)",2333,1432,61.4,1392,876,516,62.9
75607001509,"Stans",5944,3670,61.7,3565,1779,1786,49.9
75607001510,"Stansstad",3324,1979,59.5,1945,1153,792,59.3
75607001511,"Wolfenschiessen",1530,887,58,873,591,282,67.7
75608001630,"Glarus Nord",11138,5370,48.2,5304,3327,1977,62.7
75608001631,"Glarus Süd",7041,4005,56.9,3971,2361,1610,59.5
75608001632,"Glarus",7970,3940,49.4,3899,2136,1763,54.8
75609001701,"Baar",13692,8111,59.2,8068,4084,3984,50.6
75609001702,"Cham",9731,5730,58.9,5689,2826,2863,49.7
75609001703,"Hünenberg",5878,3712,63.2,3686,1694,1992,46
75609001704,"Menzingen",2925,1828,62.5,1823,1004,819,55.1
75609001705,"Neuheim",1319,880,66.7,875,505,370,57.7
75609001706,"Oberägeri",3611,2288,63.4,2276,1361,915,59.8
75609001707,"Risch",6132,3493,57,3458,1949,1509,56.4
75609001708,"Steinhausen",5891,3617,61.4,3592,1698,1894,47.3
75609001709,"Unterägeri",5311,3212,60.5,3193,1810,1383,56.7
75609001710,"Walchwil",2082,1360,65.3,1355,779,576,57.5
75609001711,"Zug",16813,10630,63.2,10549,4547,6002,43.1
75610012004,"Bussy (FR)",286,152,53.1,147,83,64,56.5
75610012005,"Châbles",477,277,58.1,273,144,129,52.7
75610012008,"Châtillon (FR)",297,190,64,189,85,104,45
75610012009,"Cheiry",275,175,63.6,175,119,56,68
75610012010,"Cheyres",928,536,57.8,530,265,265,50
75610012011,"Cugy (FR)",1013,598,59,596,334,262,56
75610012013,"Domdidier",1758,976,55.5,937,479,458,51.1
75610012014,"Dompierre (FR)",544,279,51.3,247,158,89,64
75610012015,"Estavayer-le-Lac",3543,1914,54,1879,883,996,47
75610012016,"Fétigny",569,338,59.4,324,178,146,54.9
75610012022,"Gletterens",665,383,57.6,377,230,147,61
75610012024,"Léchelles",456,262,57.5,261,131,130,50.2
75610012025,"Lully (FR)",648,395,61,393,246,147,62.6
75610012027,"Ménières",234,127,54.3,125,74,51,59.2
75610012029,"Montagny (FR)",1545,869,56.2,858,455,403,53
75610012033,"Morens (FR)",96,61,63.5,60,46,14,76.7
75610012034,"Murist",423,242,57.2,235,118,117,50.2
75610012035,"Nuvilly",273,162,59.3,158,91,67,57.6
75610012038,"Prévondavaux",42,32,76.2,32,18,14,56.3
75610012039,"Rueyres-les-Prés",256,151,59,151,85,66,56.3
75610012040,"Russy",171,108,63.2,104,64,40,61.5
75610012041,"Saint-Aubin (FR)",982,589,60,586,294,292,50.2
75610012043,"Sévaz",150,89,59.3,88,44,44,50
75610012044,"Surpierre",244,142,58.2,142,100,42,70.4
75610012045,"Vallon",249,131,52.6,130,70,60,53.8
75610012047,"Villeneuve (FR)",264,146,55.3,143,73,70,51
75610012049,"Vuissens",151,86,57,85,52,33,61.2
75610012050,"Les Montets",872,500,57.3,492,301,191,61.2
75610012051,"Delley-Portalban",756,419,55.4,415,240,175,57.8
75610012052,"Vernay",742,430,58,420,225,195,53.6
75610022061,"Auboranges",181,112,61.9,110,67,43,60.9
75610022063,"Billens-Hennens",463,264,57,263,147,116,55.9
75610022066,"Chapelle (Glâne)",175,102,58.3,101,51,50,50.5
75610022067,"Le Châtelard",268,127,47.4,125,74,51,59.2
75610022068,"Châtonnaye",501,285,56.9,280,136,144,48.6
75610022072,"Ecublens (FR)",235,150,63.8,148,77,71,52
75610022079,"Grangettes",131,86,65.6,86,49,37,57
75610022086,"Massonnens",331,186,56.2,178,100,78,56.2
75610022087,"Mézières (FR)",704,408,58,399,251,148,62.9
75610022089,"Montet (Glâne)",253,139,54.9,137,83,54,60.6
75610022096,"Romont (FR)",2419,1256,51.9,1242,567,675,45.7
75610022097,"Rue",986,498,50.5,491,255,236,51.9
75610022099,"Siviriez",1489,779,52.3,763,433,330,56.7
75610022102,"Ursy",1766,888,50.3,875,482,393,55.1
75610022111,"Villaz-Saint-Pierre",756,439,58.1,434,205,229,47.2
75610022113,"Vuisternens-devant-Romont",1491,775,52,760,458,302,60.3
75610022114,"Villorsonnens",891,516,57.9,508,330,178,65
75610022115,"Torny",608,316,52,303,158,145,52.1
75610022116,"La Folliaz",657,401,61,393,180,213,45.8
75610032121,"Haut-Intyamon",1015,532,52.4,524,258,266,49.2
75610032122,"Pont-en-Ogoz",1178,676,57.4,665,341,324,51.3
75610032123,"Botterens",346,222,64.2,216,131,85,60.6
75610032124,"Broc",1428,796,55.7,786,399,387,50.8
75610032125,"Bulle",10773,5716,53.1,5563,2629,2934,47.3
75610032128,"Châtel-sur-Montsalvens",157,105,66.9,102,52,50,51
75610032129,"Corbières",536,311,58,307,170,137,55.4
75610032130,"Crésuz",228,129,56.6,125,67,58,53.6
75610032131,"Echarlens",497,294,59.2,290,123,167,42.4
75610032134,"Grandvillard",525,310,59,300,162,138,54
75610032135,"Gruyères",1289,693,53.8,677,307,370,45.3
75610032137,"Hauteville",401,223,55.6,213,112,101,52.6
75610032138,"Jaun",507,313,61.7,312,239,73,76.6
75610032140,"Marsens",1085,612,56.4,607,303,304,49.9
75610032143,"Morlon",396,257,64.9,249,124,125,49.8
75610032145,"Le Pâquier (FR)",732,455,62.2,448,213,235,47.5
75610032147,"Pont-la-Ville",391,215,55,214,118,96,55.1
75610032148,"Riaz",1476,890,60.3,870,454,416,52.2
75610032149,"La Roche",1035,557,53.8,548,339,209,61.9
75610032152,"Sâles",989,578,58.4,564,290,274,51.4
75610032153,"Sorens",717,416,58,413,222,191,53.8
75610032155,"Vaulruz",718,406,56.5,394,215,179,54.6
75610032160,"Vuadens",1441,818,56.8,810,445,365,54.9
75610032162,"Bas-Intyamon",800,429,53.6,416,228,188,54.8
75610032163,"Val-de-Charmey",1615,960,59.4,937,518,419,55.3
75610042171,"Arconciel",547,303,55.4,299,123,176,41.1
75610042172,"Autafond",52,41,78.8,40,26,14,65
75610042173,"Autigny",535,320,59.8,317,154,163,48.6
75610042174,"Avry",1185,731,61.7,726,292,434,40.2
75610042175,"Belfaux",1714,978,57.1,963,395,568,41
75610042177,"Chénens",473,239,50.5,237,121,116,51.1
75610042179,"Chésopelloz",87,46,52.9,46,25,21,54.3
75610042183,"Corminboeuf",1537,985,64.1,954,361,593,37.8
75610042184,"Corpataux-Magnedens",809,471,58.2,463,211,252,45.6
75610042185,"Corserey",265,144,54.3,143,74,69,51.7
75610042186,"Cottens (FR)",867,494,57,483,221,262,45.8
75610042189,"Ependes (FR)",757,478,63.1,467,220,247,47.1
75610042192,"Farvagny",1414,811,57.4,792,368,424,46.5
75610042194,"Ferpicloz",196,113,57.7,112,56,56,50
75610042196,"Fribourg",20041,11539,57.6,11322,3899,7423,34.4
75610042197,"Givisiez",1694,935,55.2,927,395,532,42.6
75610042198,"Granges-Paccot",1742,850,48.8,840,383,457,45.6
75610042200,"Grolley",1199,661,55.1,645,346,299,53.6
75610042206,"Marly",4780,2815,58.9,2773,1168,1605,42.1
75610042208,"Matran",1022,569,55.7,556,233,323,41.9
75610042211,"Neyruz (FR)",1552,927,59.7,909,357,552,39.3
75610042213,"Noréaz",429,233,54.3,225,91,134,40.4
75610042216,"Pierrafortscha",102,62,60.8,60,31,29,51.7
75610042217,"Ponthaux",464,242,52.2,241,119,122,49.4
75610042220,"Le Mouret",2081,1179,56.7,1159,667,492,57.5
75610042221,"Prez-vers-Noréaz",634,343,54.1,341,165,176,48.4
75610042222,"Rossens (FR)",876,594,67.8,587,274,313,46.7
75610042223,"Le Glèbe",822,496,60.3,486,248,238,51
75610042225,"Senèdes",110,73,66.4,72,38,34,52.8
75610042226,"Treyvaux",990,609,61.5,599,285,314,47.6
75610042228,"Villars-sur-Glâne",6444,3831,59.5,3733,1281,2452,34.3
75610042230,"Villarsel-sur-Marly",54,45,83.3,45,12,33,26.7
75610042231,"Vuisternens-en-Ogoz",544,320,58.8,315,152,163,48.3
75610042233,"Hauterive (FR)",1543,869,56.3,848,365,483,43
75610042234,"La Brillaz",1202,647,53.8,641,272,369,42.4
75610042235,"La Sonnaz",689,388,56.3,385,181,204,47
75610052243,"Barberêche",352,214,60.8,211,95,116,45
75610052250,"Courgevaux",802,423,52.7,420,203,217,48.3
75610052251,"Courlevon",239,116,48.5,112,62,50,55.4
75610052254,"Courtepin",1551,847,54.6,837,434,403,51.9
75610052257,"Cressier (FR)",523,328,62.7,323,127,196,39.3
75610052258,"Fräschels",356,230,64.6,227,127,100,55.9
75610052259,"Galmiz",435,224,51.5,223,131,92,58.7
75610052260,"Gempenach",220,130,59.1,128,77,51,60.2
75610052261,"Greng",126,86,68.3,86,51,35,59.3
75610052262,"Gurmels",2930,1472,50.2,1463,831,632,56.8
75610052264,"Jeuss",290,185,63.8,181,79,102,43.6
75610052265,"Kerzers",3018,1650,54.7,1637,824,813,50.3
75610052266,"Kleinbösingen",467,276,59.1,274,162,112,59.1
75610052270,"Lurtigen",145,90,62.1,90,52,38,57.8
75610052271,"Meyriez",432,285,66,281,121,160,43.1
75610052272,"Misery-Courtion",1020,553,54.2,537,312,225,58.1
75610052274,"Muntelier",698,471,67.5,467,182,285,39
75610052275,"Murten",4195,2460,58.6,2438,1109,1329,45.5
75610052276,"Ried bei Kerzers",688,430,62.5,428,239,189,55.8
75610052277,"Salvenach",391,239,61.1,233,136,97,58.4
75610052278,"Ulmiz",299,178,59.5,177,113,64,63.8
75610052279,"Villarepos",417,229,54.9,229,139,90,60.7
75610052280,"Bas-Vully",1361,755,55.5,748,338,410,45.2
75610052281,"Haut-Vully",1014,674,66.5,663,264,399,39.8
75610052283,"Wallenried",313,176,56.2,172,96,76,55.8
75610062291,"Alterswil",1536,838,54.6,833,522,311,62.7
75610062292,"Brünisried",516,257,49.8,256,169,87,66
75610062293,"Düdingen",5595,3161,56.5,3134,1607,1527,51.3
75610062294,"Giffers",1095,613,56,608,400,208,65.8
75610062295,"Bösingen",2508,1409,56.2,1398,737,661,52.7
75610062296,"Heitenried",1064,560,52.6,552,310,242,56.2
75610062298,"Oberschrot",864,408,47.2,407,247,160,60.7
75610062299,"Plaffeien",1488,719,48.3,714,493,221,69
75610062300,"Plasselb",760,408,53.7,408,320,88,78.4
75610062301,"Rechthalten",846,515,60.9,510,317,193,62.2
75610062302,"St. Antoni",1521,794,52.2,787,480,307,61
75610062303,"St. Silvester",745,413,55.4,412,294,118,71.4
75610062304,"St. Ursen",978,532,54.4,526,275,251,52.3
75610062305,"Schmitten (FR)",2852,1592,55.8,1583,794,789,50.2
75610062306,"Tafers",2274,1288,56.6,1280,623,657,48.7
75610062307,"Tentlingen",932,532,57.1,528,337,191,63.8
75610062308,"Ueberstorf",1828,966,52.8,962,564,398,58.6
75610062309,"Wünnewil-Flamatt",3653,1848,50.6,1824,977,847,53.6
75610062310,"Zumholz",335,181,54,178,111,67,62.4
75610072321,"Attalens",1985,1117,56.3,1103,454,649,41.2
75610072323,"Bossonnens",861,459,53.3,450,209,241,46.4
75610072325,"Châtel-Saint-Denis",3615,1969,54.5,1919,955,964,49.8
75610072328,"Granges (Veveyse)",531,342,64.4,338,140,198,41.4
75610072333,"Remaufens",624,344,55.1,341,169,172,49.6
75610072335,"Saint-Martin (FR)",680,432,63.5,429,209,220,48.7
75610072336,"Semsales",915,505,55.2,497,282,215,56.7
75610072337,"Le Flon",780,436,55.9,433,223,210,51.5
75610072338,"La Verrerie",732,377,51.5,373,198,175,53.1
75610052391,"Staatswald Galm",NA,NA,NA,NA,NA,NA,NA
75611012401,"Egerkingen",2056,1083,52.7,1078,650,428,60.3
75611012402,"Härkingen",1032,594,57.6,593,376,217,63.4
75611012403,"Kestenholz",1279,766,59.9,757,390,367,51.5
75611012404,"Neuendorf",1470,844,57.4,839,517,322,61.6
75611012405,"Niederbuchsiten",722,386,53.5,384,265,119,69
75611012406,"Oberbuchsiten",1292,712,55.1,707,427,280,60.4
75611012407,"Oensingen",3533,1823,51.6,1814,1140,674,62.8
75611012408,"Wolfwil",1552,871,56.1,865,509,356,58.8
75611022421,"Aedermannsdorf",422,277,65.6,275,170,105,61.8
75611022422,"Balsthal",3383,1953,57.7,1944,1216,728,62.6
75611022423,"Gänsbrunnen",71,40,56.3,40,30,10,75
75611022424,"Herbetswil",432,227,52.5,226,142,84,62.8
75611022425,"Holderbank (SO)",464,236,50.9,235,156,79,66.4
75611022426,"Laupersdorf",1245,751,60.3,747,497,250,66.5
75611022427,"Matzendorf",1032,624,60.5,623,425,198,68.2
75611022428,"Mümliswil-Ramiswil",1878,1205,64.2,1205,850,355,70.5
75611022429,"Welschenrohr",850,511,60.1,509,313,196,61.5
75611032445,"Biezwil",246,144,58.5,144,78,66,54.2
75611032455,"Lüterkofen-Ichertswil",579,347,59.9,344,178,166,51.7
75611032456,"Lüterswil-Gächliwil",260,173,66.5,173,102,71,59
75611032457,"Messen",1099,648,59,646,389,257,60.2
75611032461,"Schnottwil",787,459,58.3,454,249,205,54.8
75611032463,"Unterramsern",166,103,62,100,52,48,52
75611032464,"Lüsslingen-Nennigkofen",709,444,62.6,439,219,220,49.9
75611032465,"Buchegg",2002,1133,56.6,1119,568,551,50.8
75611042471,"Bättwil",813,435,53.5,430,234,196,54.4
75611042472,"Büren (SO)",668,406,60.8,405,212,193,52.3
75611042473,"Dornach",4075,2339,57.4,2304,969,1335,42.1
75611042474,"Gempen",553,356,64.4,324,169,155,52.2
75611042475,"Hochwald",937,631,67.3,626,291,335,46.5
75611042476,"Hofstetten-Flüh",2217,1296,58.5,1283,608,675,47.4
75611042477,"Metzerlen-Mariastein",722,466,64.5,466,263,203,56.4
75611042478,"Nuglar-St. Pantaleon",1113,658,59.1,654,364,290,55.7
75611042479,"Rodersdorf",979,652,66.6,641,250,391,39
75611042480,"Seewen",791,439,55.5,434,254,180,58.5
75611042481,"Witterswil",1012,636,62.8,630,320,310,50.8
75611052491,"Hauenstein-Ifenthal",233,150,64.4,150,73,77,48.7
75611052492,"Kienberg",403,245,60.8,242,162,80,66.9
75611052493,"Lostorf",2794,1745,62.5,1735,951,784,54.8
75611052495,"Niedergösgen",2319,1260,54.3,1256,766,490,61
75611052497,"Obergösgen",1418,738,52,732,432,300,59
75611052498,"Rohr (SO)",70,44,62.9,43,24,19,55.8
75611052499,"Stüsslingen",792,491,62,488,283,205,58
75611052500,"Trimbach",3616,1718,47.5,1705,901,804,52.8
75611052501,"Winznau",1318,719,54.6,715,405,310,56.6
75611052502,"Wisen (SO)",324,195,60.2,193,79,114,40.9
75611052503,"Erlinsbach (SO)",2326,1287,55.3,1277,706,571,55.3
75611062511,"Aeschi (SO)",1004,606,60.4,601,338,263,56.2
75611062513,"Biberist",5370,2806,52.3,2780,1419,1361,51
75611062514,"Bolken",419,237,56.6,234,130,104,55.6
75611062516,"Deitingen",1667,972,58.3,971,525,446,54.1
75611062517,"Derendingen",3672,1897,51.7,1884,1108,776,58.8
75611062518,"Etziken",612,338,55.2,336,212,124,63.1
75611062519,"Gerlafingen",2583,1230,47.6,1221,773,448,63.3
75611062520,"Halten",666,382,57.4,381,214,167,56.2
75611062523,"Horriwil",665,417,62.7,415,262,153,63.1
75611062524,"Hüniken",69,55,79.7,54,25,29,46.3
75611062525,"Kriegstetten",954,570,59.7,565,332,233,58.8
75611062526,"Lohn-Ammannsegg",2021,1240,61.4,1223,576,647,47.1
75611062527,"Luterbach",2392,1311,54.8,1303,731,572,56.1
75611062528,"Obergerlafingen",856,458,53.5,454,296,158,65.2
75611062529,"Oekingen",575,355,61.7,350,193,157,55.1
75611062530,"Recherswil",1335,727,54.5,720,450,270,62.5
75611062532,"Subingen",2077,1133,54.5,1128,695,433,61.6
75611062534,"Zuchwil",4495,2093,46.6,2084,1077,1007,51.7
75611062535,"Drei Höfe",593,357,60.2,356,223,133,62.6
75611072541,"Balm bei Günsberg",149,102,68.5,100,62,38,62
75611072542,"Bellach",3254,1749,53.7,1740,1037,703,59.6
75611072543,"Bettlach",3422,1866,54.5,1851,1145,706,61.9
75611072544,"Feldbrunnen-St. Niklaus",756,529,70,523,217,306,41.5
75611072545,"Flumenthal",746,418,56,417,282,135,67.6
75611072546,"Grenchen",9815,4642,47.3,4604,2826,1778,61.4
75611072547,"Günsberg",892,546,61.2,541,343,198,63.4
75611072548,"Hubersdorf",564,311,55.1,307,163,144,53.1
75611072549,"Kammersrohr",37,17,45.9,17,8,9,47.1
75611072550,"Langendorf",2730,1536,56.3,1523,703,820,46.2
75611072551,"Lommiswil",1133,697,61.5,689,348,341,50.5
75611072553,"Oberdorf (SO)",1253,791,63.1,786,345,441,43.9
75611072554,"Riedholz",1666,936,56.2,930,501,429,53.9
75611072555,"Rüttenen",1157,744,64.3,735,370,365,50.3
75611072556,"Selzach",2271,1163,51.2,1155,740,415,64.1
75611082571,"Boningen",543,275,50.6,272,173,99,63.6
75611082572,"Däniken",1906,1117,58.6,1110,724,386,65.2
75611082573,"Dulliken",2489,1426,57.3,1415,808,607,57.1
75611082574,"Eppenberg-Wöschnau",196,104,53.1,104,72,32,69.2
75611082575,"Fulenbach",1226,706,57.6,701,419,282,59.8
75611082576,"Gretzenbach",1709,1024,59.9,1017,570,447,56
75611082578,"Gunzgen",1198,668,55.8,664,411,253,61.9
75611082579,"Hägendorf",3102,1782,57.4,1774,1048,726,59.1
75611082580,"Kappel (SO)",2103,1191,56.6,1183,648,535,54.8
75611082581,"Olten",11163,6204,55.6,6148,2557,3591,41.6
75611082582,"Rickenbach (SO)",674,376,55.8,372,209,163,56.2
75611082583,"Schönenwerd",2580,1344,52.1,1331,762,569,57.3
75611082584,"Starrkirch-Wil",1169,738,63.1,735,317,418,43.1
75611082585,"Walterswil (SO)",582,297,51,297,207,90,69.7
75611082586,"Wangen bei Olten",3261,1776,54.5,1764,903,861,51.2
75611092601,"Solothurn",11680,6483,55.5,6411,2215,4196,34.5
75611102611,"Bärschwil",670,382,57,377,246,131,65.3
75611102612,"Beinwil (SO)",214,144,67.3,144,90,54,62.5
75611102613,"Breitenbach",2249,1114,49.5,1101,714,387,64.9
75611102614,"Büsserach",1503,856,57,851,551,300,64.7
75611102615,"Erschwil",677,406,60,405,262,143,64.7
75611102616,"Fehren",473,259,54.8,257,168,89,65.4
75611102617,"Grindel",366,198,54.1,197,136,61,69
75611102618,"Himmelried",721,465,64.5,465,250,215,53.8
75611102619,"Kleinlützel",964,528,54.8,525,310,215,59
75611102620,"Meltingen",496,286,57.7,286,191,95,66.8
75611102621,"Nunningen",1422,836,58.8,828,506,322,61.1
75611102622,"Zullwil",444,259,58.3,259,174,85,67.2
75612002701,"Basel",92617,52965,57.2,52309,20250,32059,38.7
75612002702,"Bettingen",741,501,67.6,498,210,288,42.2
75612002703,"Riehen",13528,8474,62.6,8381,3697,4684,44.1
75613012761,"Aesch (BL)",6653,3358,50.5,3327,1657,1670,49.8
75613012762,"Allschwil",13305,7180,54,7067,3527,3540,49.9
75613012763,"Arlesheim",6165,3597,58.3,3492,1273,2219,36.5
75613012764,"Biel-Benken",2308,1368,59.3,1342,636,706,47.4
75613012765,"Binningen",9987,5823,58.3,5759,2494,3265,43.3
75613012766,"Birsfelden",6614,3239,49,3152,1714,1438,54.4
75613012767,"Bottmingen",4228,2567,60.7,2511,1087,1424,43.3
75613012768,"Ettingen",3498,2013,57.5,1992,1009,983,50.7
75613012769,"Münchenstein",7664,4195,54.7,4155,1968,2187,47.4
75613012770,"Muttenz",12116,6343,52.4,6282,3165,3117,50.4
75613012771,"Oberwil (BL)",7238,4222,58.3,4117,1844,2273,44.8
75613012772,"Pfeffingen",1676,1026,61.2,1000,509,491,50.9
75613012773,"Reinach (BL)",12977,7279,56.1,7076,3540,3536,50
75613012774,"Schönenbuch",1048,616,58.8,607,298,309,49.1
75613012775,"Therwil",6812,3844,56.4,3738,1820,1918,48.7
75613022781,"Blauen",547,316,57.8,315,175,140,55.6
75613022782,"Brislach",1154,577,50,567,383,184,67.5
75613022783,"Burg im Leimental",195,118,60.5,113,67,46,59.3
75613022784,"Dittingen",562,317,56.4,312,177,135,56.7
75613022785,"Duggingen",985,552,56,547,299,248,54.7
75613022786,"Grellingen",1105,598,54.1,593,358,235,60.4
75613022787,"Laufen",3451,1808,52.4,1795,902,893,50.3
75613022788,"Liesberg",896,508,56.7,493,349,144,70.8
75613022789,"Nenzlingen",305,150,49.2,150,101,49,67.3
75613022790,"Roggenburg",244,133,54.5,133,92,41,69.2
75613022791,"Röschenz",1378,859,62.3,856,554,302,64.7
75613022792,"Wahlen",1035,523,50.5,519,339,180,65.3
75613022793,"Zwingen",1441,659,45.7,645,389,256,60.3
75613032821,"Arisdorf",1183,629,53.2,613,357,256,58.2
75613032822,"Augst",638,382,59.9,381,216,165,56.7
75613032823,"Bubendorf",3189,1838,57.6,1802,835,967,46.3
75613032824,"Frenkendorf",3728,1878,50.4,1841,974,867,52.9
75613032825,"Füllinsdorf",2767,1528,55.2,1490,796,694,53.4
75613032826,"Giebenach",697,355,50.9,353,234,119,66.3
75613032827,"Hersberg",244,128,52.5,128,86,42,67.2
75613032828,"Lausen",3101,1964,63.3,1912,1018,894,53.2
75613032829,"Liestal",8692,4691,54,4573,2032,2541,44.4
75613032830,"Lupsingen",991,569,57.4,565,265,300,46.9
75613032831,"Pratteln",8055,3791,47.1,3703,1898,1805,51.3
75613032832,"Ramlinsburg",521,309,59.3,304,139,165,45.7
75613032833,"Seltisberg",1015,675,66.5,661,317,344,48
75613032834,"Ziefen",1135,637,56.1,635,305,330,48
75613042841,"Anwil",422,237,56.2,235,135,100,57.4
75613042842,"Böckten",588,327,55.6,324,189,135,58.3
75613042843,"Buckten",484,298,61.6,293,174,119,59.4
75613042844,"Buus",775,427,55.1,420,271,149,64.5
75613042845,"Diepflingen",493,255,51.7,255,162,93,63.5
75613042846,"Gelterkinden",3965,2141,54,2111,1021,1090,48.4
75613042847,"Häfelfingen",204,132,64.7,131,88,43,67.2
75613042848,"Hemmiken",219,127,58,126,84,42,66.7
75613042849,"Itingen",1357,741,54.6,729,407,322,55.8
75613042850,"Känerkinden",378,228,60.3,224,123,101,54.9
75613042851,"Kilchberg (BL)",122,91,74.6,84,47,37,56
75613042852,"Läufelfingen",946,525,55.5,517,315,202,60.9
75613042853,"Maisprach",674,400,59.3,392,212,180,54.1
75613042854,"Nusshof",187,111,59.4,110,55,55,50
75613042855,"Oltingen",356,208,58.4,206,107,99,51.9
75613042856,"Ormalingen",1491,757,50.8,748,416,332,55.6
75613042857,"Rickenbach (BL)",436,246,56.4,241,144,97,59.8
75613042858,"Rothenfluh",588,320,54.4,316,173,143,54.7
75613042859,"Rümlingen",227,128,56.4,126,81,45,64.3
75613042860,"Rünenberg",614,351,57.2,341,197,144,57.8
75613042861,"Sissach",4467,2544,57,2488,1189,1299,47.8
75613042862,"Tecknau",496,252,50.8,247,151,96,61.1
75613042863,"Tenniken",688,359,52.2,352,182,170,51.7
75613042864,"Thürnen",938,500,53.3,499,326,173,65.3
75613042865,"Wenslingen",549,340,61.9,333,197,136,59.2
75613042866,"Wintersingen",494,275,55.7,274,161,113,58.8
75613042867,"Wittinsburg",298,187,62.8,179,113,66,63.1
75613042868,"Zeglingen",353,226,64,221,116,105,52.5
75613042869,"Zunzgen",1755,1006,57.3,1001,589,412,58.8
75613052881,"Arboldswil",416,266,63.9,266,164,102,61.7
75613052882,"Bennwil",465,282,60.6,282,182,100,64.5
75613052883,"Bretzwil",560,316,56.4,313,227,86,72.5
75613052884,"Diegten",1166,615,52.7,612,402,210,65.7
75613052885,"Eptingen",396,232,58.6,230,153,77,66.5
75613052886,"Hölstein",1647,929,56.4,898,464,434,51.7
75613052887,"Lampenberg",388,257,66.2,256,145,111,56.6
75613052888,"Langenbruck",699,364,52.1,362,206,156,56.9
75613052889,"Lauwil",262,152,58,150,77,73,51.3
75613052890,"Liedertswil",123,78,63.4,78,59,19,75.6
75613052891,"Niederdorf",1135,584,51.5,574,361,213,62.9
75613052892,"Oberdorf (BL)",1513,785,51.9,778,459,319,59
75613052893,"Reigoldswil",1140,558,48.9,555,333,222,60
75613052894,"Titterten",333,226,67.9,216,107,109,49.5
75613052895,"Waldenburg",753,346,45.9,344,215,129,62.5
75614012901,"Gächlingen",627,474,75.6,436,275,161,63.1
75614012903,"Löhningen",939,704,75,684,431,253,63
75614012904,"Neunkirch",1399,1036,74.1,986,560,426,56.8
75614022914,"Büttenhardt",263,200,76,193,126,67,65.3
75614022915,"Dörflingen",638,515,80.7,491,365,126,74.3
75614022917,"Lohn (SH)",539,440,81.6,417,300,117,71.9
75614022919,"Stetten (SH)",819,609,74.4,601,319,282,53.1
75614022920,"Thayngen",3318,2567,77.4,2485,1648,837,66.3
75614032931,"Bargen (SH)",184,152,82.6,148,118,30,79.7
75614032932,"Beringen",2786,1948,69.9,1884,1189,695,63.1
75614032933,"Buchberg",624,527,84.5,511,309,202,60.5
75614032936,"Merishausen",537,441,82.1,434,301,133,69.4
75614032937,"Neuhausen am Rheinfall",5598,3582,64,3437,2073,1364,60.3
75614032938,"Rüdlingen",562,420,74.7,410,249,161,60.7
75614032939,"Schaffhausen",22502,15446,68.6,14886,7621,7265,51.2
75614042951,"Beggingen",388,275,70.9,271,207,64,76.4
75614042952,"Schleitheim",1250,836,66.9,795,529,266,66.5
75614042953,"Siblingen",598,420,70.2,412,251,161,60.9
75614052961,"Buch (SH)",206,127,61.7,121,88,33,72.7
75614052962,"Hemishofen",324,249,76.9,240,167,73,69.6
75614052963,"Ramsen",862,626,72.6,609,426,183,70
75614052964,"Stein am Rhein",2244,1585,70.6,1544,838,706,54.3
75614062971,"Hallau",1462,1060,72.5,1035,700,335,67.6
75614062972,"Oberhallau",327,256,78.3,246,184,62,74.8
75614062973,"Trasadingen",389,270,69.4,264,182,82,68.9
75614062974,"Wilchingen",1199,891,74.3,855,538,317,62.9
75615013001,"Herisau",10449,5460,52.3,5420,2946,2474,54.4
75615013002,"Hundwil",697,369,52.9,369,268,101,72.6
75615013003,"Schönengrund",376,127,33.8,127,102,25,80.3
75615013004,"Schwellbrunn",1130,658,58.2,656,466,190,71
75615013005,"Stein (AR)",1062,656,61.8,653,395,258,60.5
75615013006,"Urnäsch",1614,904,56,895,587,308,65.6
75615013007,"Waldstatt",1219,760,62.3,749,459,290,61.3
75615023021,"Bühler",1015,633,62.4,627,387,240,61.7
75615023022,"Gais",2216,1392,62.8,1382,725,657,52.5
75615023023,"Speicher",3070,2012,65.5,2004,962,1042,48
75615023024,"Teufen (AR)",4581,2954,64.5,2941,1353,1588,46
75615023025,"Trogen",1277,801,62.7,794,288,506,36.3
75615033031,"Grub (AR)",738,437,59.2,431,250,181,58
75615033032,"Heiden",2717,1534,56.5,1524,813,711,53.3
75615033033,"Lutzenberg",889,542,61,538,359,179,66.7
75615033034,"Rehetobel",1287,806,62.6,802,367,435,45.8
75615033035,"Reute (AR)",500,308,61.6,305,191,114,62.6
75615033036,"Wald (AR)",639,344,53.8,340,171,169,50.3
75615033037,"Walzenhausen",1401,631,45,626,391,235,62.5
75615033038,"Wolfhalden",1233,680,55.2,676,410,266,60.7
75616003101,"Appenzell",3827,1928,50.4,1867,1114,753,59.7
75616003102,"Gonten",1084,557,51.4,553,398,155,72
75616003103,"Rüte",2458,1338,54.4,1305,851,454,65.2
75616003104,"Schlatt-Haslen",862,436,50.6,430,301,129,70
75616003105,"Schwende",1485,755,50.8,734,477,257,65
75616003111,"Oberegg",1430,870,60.8,850,517,333,60.8
75617213201,"Häggenschwil",848,529,62.4,528,299,229,56.6
75617213202,"Muolen",828,483,58.3,478,285,193,59.6
75617213203,"St. Gallen",45184,25016,55.4,24789,10050,14739,40.5
75617213204,"Wittenbach",6066,3340,55.1,3321,1875,1446,56.5
75617223211,"Berg (SG)",608,390,64.1,390,224,166,57.4
75617213212,"Eggersriet",1614,1000,62,991,534,457,53.9
75617223213,"Goldach",5903,3201,54.2,3185,1775,1410,55.7
75617223214,"Mörschwil",2571,1689,65.7,1684,830,854,49.3
75617223215,"Rorschach",4134,2047,49.5,2040,988,1052,48.4
75617223216,"Rorschacherberg",4262,2475,58.1,2462,1436,1026,58.3
75617223217,"Steinach",2191,1146,52.3,1137,656,481,57.7
75617223218,"Tübach",897,533,59.4,525,263,262,50.1
75617223219,"Untereggen",731,446,61,444,263,181,59.2
75617233231,"Au (SG)",3836,2048,53.4,2040,1236,804,60.6
75617233232,"Balgach",2826,1633,57.8,1623,894,729,55.1
75617233233,"Berneck",2549,1483,58.2,1472,801,671,54.4
75617233234,"Diepoldsau",3644,1943,53.3,1932,1186,746,61.4
75617233235,"Rheineck",1767,983,55.6,976,597,379,61.2
75617233236,"St. Margrethen",2589,1363,52.6,1357,876,481,64.6
75617223237,"Thal",4038,2317,57.4,2304,1421,883,61.7
75617233238,"Widnau",5256,2903,55.2,2883,1763,1120,61.2
75617233251,"Altstätten",6843,3598,52.6,3575,2246,1329,62.8
75617233252,"Eichberg",968,546,56.4,542,378,164,69.7
75617233253,"Marbach (SG)",1347,733,54.4,731,463,268,63.3
75617233254,"Oberriet (SG)",5724,3197,55.9,3185,2199,986,69
75617233255,"Rebstein",2480,1361,54.9,1352,864,488,63.9
75617233256,"Rüthi (SG)",1375,772,56.1,771,545,226,70.7
75617243271,"Buchs (SG)",6501,3394,52.2,3377,1865,1512,55.2
75617243272,"Gams",2013,1167,58,1163,691,472,59.4
75617243273,"Grabs",4560,2499,54.8,2486,1370,1116,55.1
75617243274,"Sennwald",3028,1670,55.2,1665,1092,573,65.6
75617243275,"Sevelen",2522,1351,53.6,1339,810,529,60.5
75617243276,"Wartau",3007,1683,56,1672,1023,649,61.2
75617253291,"Bad Ragaz",3443,1912,55.5,1900,1047,853,55.1
75617253292,"Flums",3060,1614,52.7,1610,1142,468,70.9
75617253293,"Mels",5738,3156,55,3142,2019,1123,64.3
75617253294,"Pfäfers",1071,579,54.1,577,356,221,61.7
75617253295,"Quarten",1951,1093,56,1085,701,384,64.6
75617253296,"Sargans",3750,2040,54.4,2032,1100,932,54.1
75617253297,"Vilters-Wangs",3067,1740,56.7,1734,1069,665,61.6
75617253298,"Walenstadt",3558,1928,54.2,1921,1122,799,58.4
75617263311,"Amden",1327,757,57,753,479,274,63.6
75617263312,"Benken (SG)",1891,1030,54.5,1026,705,321,68.7
75617263313,"Kaltbrunn",2897,1516,52.3,1504,993,511,66
75617263315,"Schänis",2629,1381,52.5,1368,940,428,68.7
75617263316,"Weesen",1095,616,56.3,611,320,291,52.4
75617263338,"Schmerikon",2168,1196,55.2,1192,700,492,58.7
75617263339,"Uznach",3637,1934,53.2,1927,1092,835,56.7
75617263340,"Rapperswil-Jona",17952,10324,57.5,10253,5202,5051,50.7
75617263341,"Gommiswald",3490,1999,57.3,1988,1350,638,67.9
75617263342,"Eschenbach (SG)",6012,3318,55.2,3295,2202,1093,66.8
75617273352,"Ebnat-Kappel",3452,2105,61,2086,1238,848,59.3
75617273359,"Wildhaus-Alt St. Johann",1838,1035,56.3,1029,665,364,64.6
75617273360,"Nesslau",2661,1538,57.8,1525,967,558,63.4
75617273372,"Hemberg",670,445,66.4,441,287,154,65.1
75617273374,"Lichtensteig",1315,679,51.6,676,340,336,50.3
75617273375,"Oberhelfenschwil",945,536,56.7,533,324,209,60.8
75617273378,"Neckertal",2918,1637,56.1,1627,1083,544,66.6
75617273379,"Wattwil",5361,2985,55.7,2969,1688,1281,56.9
75617273392,"Kirchberg (SG)",4940,2753,55.7,2744,1728,1016,63
75617273393,"Lütisburg",975,597,61.2,593,377,216,63.6
75617273394,"Mosnang",2062,1142,55.4,1137,767,370,67.5
75617273395,"Bütschwil-Ganterschwil",3136,1734,55.3,1727,1107,620,64.1
75617283401,"Degersheim",2524,1468,58.2,1460,793,667,54.3
75617283402,"Flawil",5916,3150,53.2,3130,1693,1437,54.1
75617283405,"Jonschwil",2523,1451,57.5,1440,924,516,64.2
75617283407,"Oberuzwil",4030,2246,55.7,2225,1278,947,57.4
75617283408,"Uzwil",7430,4031,54.3,4014,2319,1695,57.8
75617283422,"Niederbüren",1033,587,56.8,581,396,185,68.2
75617283423,"Niederhelfenschwil",2035,1128,55.4,1123,710,413,63.2
75617283424,"Oberbüren",2914,1651,56.7,1644,1113,531,67.7
75617283426,"Zuzwil (SG)",3321,1975,59.5,1958,1132,826,57.8
75617283427,"Wil (SG)",14236,8015,56.3,7966,4111,3855,51.6
75617213441,"Andwil (SG)",1343,849,63.2,841,431,410,51.2
75617213442,"Gaiserwald",5573,3316,59.5,3294,1697,1597,51.5
75617213443,"Gossau (SG)",12012,6686,55.7,6649,3786,2863,56.9
75617213444,"Waldkirch",2385,1364,57.2,1359,916,443,67.4
75618213501,"Alvaschein",116,49,42.2,49,22,27,44.9
75618213502,"Mon",72,44,61.1,44,18,26,40.9
75618213503,"Mutten",59,39,66.1,38,25,13,65.8
75618213504,"Stierva",98,36,36.7,33,11,22,33.3
75618213505,"Tiefencastel",179,77,43,77,39,38,50.6
75618213506,"Vaz/Obervaz",1799,951,52.9,930,461,469,49.6
75618213511,"Alvaneu",313,163,52.1,163,82,81,50.3
75618213512,"Brienz/Brinzauls",99,45,45.5,45,25,20,55.6
75618213513,"Lantsch/Lenz",377,164,43.5,161,67,94,41.6
75618213514,"Schmitten (GR)",203,93,45.8,93,50,43,53.8
75618213515,"Surava",151,67,44.4,66,36,30,54.5
75618213521,"Bergün/Bravuogn",340,174,51.2,174,88,86,50.6
75618213522,"Filisur",327,186,56.9,185,90,95,48.6
75618213531,"Bivio",136,62,45.6,62,27,35,43.5
75618213532,"Cunter",157,80,51,78,40,38,51.3
75618213533,"Marmorera",34,21,61.8,21,11,10,52.4
75618213534,"Mulegns",26,13,50,13,7,6,53.8
75618213536,"Riom-Parsonz",246,95,38.6,95,36,59,37.9
75618213538,"Salouf",170,79,46.5,79,40,39,50.6
75618213539,"Savognin",728,333,45.7,331,145,186,43.8
75618213540,"Sur",62,32,51.6,32,15,17,46.9
75618213541,"Tinizong-Rona",233,127,54.5,125,40,85,32
75618223551,"Brusio",913,422,46.2,416,272,144,65.4
75618223561,"Poschiavo",2813,1479,52.6,1454,817,637,56.2
75618313572,"Falera",444,277,62.4,273,129,144,47.3
75618313575,"Laax",1088,580,53.3,578,288,290,49.8
75618313581,"Sagogn",507,254,50.1,253,107,146,42.3
75618313582,"Schluein",393,160,40.7,159,89,70,56
75618313598,"St. Martin",31,13,41.9,13,8,5,61.5
75618313603,"Vals",731,317,43.4,315,118,197,37.5
75618313611,"Andiast",171,76,44.4,74,43,31,58.1
75618313612,"Obersaxen",640,298,46.6,294,177,117,60.2
75618313616,"Waltensburg/Vuorz",287,134,46.7,131,46,85,35.1
75618313617,"Mundaun",249,109,43.8,107,59,48,55.1
75618313618,"Lumnezia",1790,731,40.8,722,379,343,52.5
75618313619,"Ilanz/Glion",3286,1587,48.3,1523,781,742,51.3
75618233631,"Almens",167,101,60.5,99,40,59,40.4
75618233633,"Fürstenau",263,144,54.8,142,69,73,48.6
75618233634,"Paspels",354,213,60.2,212,73,139,34.4
75618233635,"Pratval",216,128,59.3,127,53,74,41.7
75618233636,"Rodels",224,132,58.9,131,58,73,44.3
75618233637,"Rothenbrunnen",222,120,54.1,119,70,49,58.8
75618233638,"Scharans",653,375,57.4,369,198,171,53.7
75618233640,"Sils im Domleschg",625,311,49.8,308,183,125,59.4
75618233661,"Cazis",1524,736,48.3,721,401,320,55.6
75618233662,"Flerden",159,90,56.6,86,33,53,38.4
75618233663,"Masein",353,213,60.3,211,82,129,38.9
75618233668,"Thusis",1738,833,47.9,826,421,405,51
75618233669,"Tschappina",114,63,55.3,60,22,38,36.7
75618233670,"Urmein",114,71,62.3,71,34,37,47.9
75618233671,"Tomils",565,312,55.2,312,148,164,47.4
75618313672,"Safiental",725,390,53.8,380,176,204,46.3
75618233681,"Avers",138,88,63.8,88,57,31,64.8
75618233691,"Hinterrhein",50,35,70,34,10,24,29.4
75618233693,"Nufenen",106,60,56.6,60,29,31,48.3
75618233694,"Splügen",322,189,58.7,187,86,101,46
75618233695,"Sufers",104,67,64.4,67,29,38,43.3
75618233701,"Andeer",656,363,55.3,354,172,182,48.6
75618233703,"Casti-Wergenstein",40,22,55,22,16,6,72.7
75618233705,"Donat",163,83,50.9,83,29,54,34.9
75618233707,"Lohn (GR)",35,24,68.6,24,9,15,37.5
75618233708,"Mathon",45,14,31.1,14,4,10,28.6
75618233711,"Rongellen",44,29,65.9,29,17,12,58.6
75618233712,"Zillis-Reischen",277,151,54.5,150,83,67,55.3
75618233713,"Ferrera",69,40,58,40,23,17,57.5
75618243721,"Bonaduz",2113,1124,53.2,1116,588,528,52.7
75618243722,"Domat/Ems",4725,2438,51.6,2417,1231,1186,50.9
75618243723,"Rhäzüns",888,429,48.3,421,226,195,53.7
75618243731,"Felsberg",1696,933,55,916,461,455,50.3
75618243732,"Flims",1839,1038,56.4,1028,500,528,48.6
75618243733,"Tamins",890,479,53.8,476,218,258,45.8
75618243734,"Trin",909,529,58.2,523,209,314,40
75618253741,"Ardez",333,141,42.3,141,46,95,32.6
75618253742,"Guarda",119,66,55.5,64,26,38,40.6
75618253743,"Lavin",171,96,56.1,96,24,72,25
75618253744,"Susch",158,99,62.7,98,43,55,43.9
75618253745,"Tarasp",188,87,46.3,87,36,51,41.4
75618253746,"Zernez",775,425,54.8,418,224,194,53.6
75618253752,"Samnaun",529,196,37.1,193,106,87,54.9
75618253761,"Ftan",370,189,51.1,188,62,126,33
75618253762,"Scuol",1451,720,49.6,705,311,394,44.1
75618253763,"Sent",735,343,46.7,335,136,199,40.6
75618253764,"Valsot",717,255,35.6,252,101,151,40.1
75618273781,"Bever",459,291,63.4,289,124,165,42.9
75618273782,"Celerina/Schlarigna",849,466,54.9,460,203,257,44.1
75618273783,"Madulain",136,91,66.9,89,37,52,41.6
75618273784,"Pontresina",1195,685,57.3,678,321,357,47.3
75618273785,"La Punt-Chamues-ch",475,257,54.1,253,128,125,50.6
75618273786,"Samedan",1955,1221,62.5,1195,555,640,46.4
75618273787,"St. Moritz",2701,1577,58.4,1548,728,820,47
75618273788,"S-chanf",513,274,53.4,268,138,130,51.5
75618273789,"Sils im Engadin/Segl",428,230,53.7,230,85,145,37
75618273790,"Silvaplana",633,306,48.3,293,143,150,48.8
75618273791,"Zuoz",687,412,60,411,203,208,49.4
75618273792,"Bregaglia",1219,645,52.9,630,337,293,53.5
75618283801,"Arvigo",86,39,45.3,39,31,8,79.5
75618283803,"Braggio",48,26,54.2,26,8,18,30.8
75618283804,"Buseno",78,44,56.4,44,27,17,61.4
75618283805,"Castaneda",213,115,54,110,67,43,60.9
75618283806,"Cauco",29,15,51.7,15,4,11,26.7
75618283808,"Rossa",130,80,61.5,75,57,18,76
75618283810,"Santa Maria in Calanca",103,56,54.4,55,38,17,69.1
75618283811,"Selma",36,20,55.6,20,15,5,75
75618283821,"Lostallo",514,295,57.4,294,223,71,75.9
75618283822,"Mesocco",922,397,43.1,389,261,128,67.1
75618283823,"Soazza",265,147,55.5,145,96,49,66.2
75618283831,"Cama",368,173,47,171,135,36,78.9
75618283832,"Grono",579,344,59.4,339,249,90,73.5
75618283833,"Leggia",101,59,58.4,59,52,7,88.1
75618283834,"Roveredo (GR)",1609,829,51.5,817,592,225,72.5
75618283835,"San Vittore",529,306,57.8,302,208,94,68.9
75618283836,"Verdabbio",125,68,54.4,68,44,24,64.7
75618253847,"Val Müstair",1211,566,46.7,564,282,282,50
75618303851,"Davos",7143,3502,49,3458,1653,1805,47.8
75618303861,"Fideris",461,239,51.8,239,150,89,62.8
75618303862,"Furna",140,77,55,77,52,25,67.5
75618303863,"Jenaz",862,457,53,456,289,167,63.4
75618303871,"Klosters-Serneus",2631,1554,59.1,1532,948,584,61.9
75618303881,"Conters im Prättigau",168,86,51.2,86,65,21,75.6
75618303882,"Küblis",581,278,47.8,276,196,80,71
75618303883,"Saas",538,263,48.9,262,205,57,78.2
75618303891,"Luzein",923,492,53.3,485,312,173,64.3
75618303893,"St. Antönien",262,142,54.2,141,114,27,80.9
75618293901,"Chur",24231,13772,56.8,13414,6027,7387,44.9
75618293911,"Churwalden",1423,705,49.5,679,356,323,52.4
75618293921,"Arosa",2276,1146,50.4,1121,581,540,51.8
75618293926,"Maladers",421,219,52,219,145,74,66.2
75618293932,"Tschiertschen-Praden",254,114,44.9,113,54,59,47.8
75618263941,"Haldenstein",709,382,53.9,377,171,206,45.4
75618263945,"Trimmis",2265,1242,54.8,1213,664,549,54.7
75618263946,"Untervaz",1688,790,46.8,779,433,346,55.6
75618263947,"Zizers",2286,1156,50.6,1140,551,589,48.3
75618263951,"Fläsch",528,303,57.4,296,166,130,56.1
75618263952,"Jenins",655,364,55.6,361,196,165,54.3
75618263953,"Maienfeld",2035,1114,54.7,1103,530,573,48.1
75618263954,"Malans",1738,1041,59.9,1031,442,589,42.9
75618263955,"Landquart",5770,2832,49.1,2767,1528,1239,55.2
75618303961,"Grüsch",1420,762,53.7,747,410,337,54.9
75618303962,"Schiers",1799,895,49.7,871,507,364,58.2
75618303972,"Seewis im Prättigau",1022,475,46.5,468,260,208,55.6
75618313981,"Breil/Brigels",1001,511,51,508,256,252,50.4
75618313982,"Disentis/Mustér",1585,859,54.2,850,433,417,50.9
75618313983,"Medel (Lucmagn)",341,175,51.3,173,74,99,42.8
75618313985,"Sumvitg",1023,546,53.4,537,248,289,46.2
75618313986,"Tujetsch",1041,522,50.1,514,259,255,50.4
75618313987,"Trun",1013,438,43.2,435,194,241,44.6
75619014001,"Aarau",13780,8276,60.1,8178,3243,4935,39.7
75619014002,"Biberstein",1120,745,66.5,739,350,389,47.4
75619014003,"Buchs (AG)",4173,2128,51,2116,1062,1054,50.2
75619014004,"Densbüren",521,287,55.1,286,187,99,65.4
75619014005,"Erlinsbach (AG)",2689,1589,59.1,1578,813,765,51.5
75619014006,"Gränichen",4703,2593,55.1,2574,1559,1015,60.6
75619014007,"Hirschthal",1092,627,57.4,626,423,203,67.6
75619014008,"Küttigen",4125,2573,62.4,2550,1120,1430,43.9
75619014009,"Muhen",2635,1443,54.8,1436,926,510,64.5
75619014010,"Oberentfelden",4611,2416,52.4,2403,1438,965,59.8
75619014012,"Suhr",5395,2952,54.7,2927,1405,1522,48
75619014013,"Unterentfelden",2499,1426,57.1,1404,729,675,51.9
75619024021,"Baden",11339,6848,60.4,6797,2360,4437,34.7
75619024022,"Bellikon",1166,752,64.5,749,412,337,55
75619024023,"Bergdietikon",1785,1126,63.1,1120,672,448,60
75619024024,"Birmenstorf (AG)",1859,1079,58,1074,586,488,54.6
75619024026,"Ennetbaden",2139,1425,66.6,1422,393,1029,27.6
75619024027,"Fislisbach",3409,1772,52,1757,955,802,54.4
75619024028,"Freienwil",645,398,61.7,394,203,191,51.5
75619024029,"Gebenstorf",2989,1652,55.3,1643,841,802,51.2
75619024030,"Killwangen",1121,624,55.7,622,356,266,57.2
75619024031,"Künten",1131,626,55.3,622,370,252,59.5
75619024032,"Mägenwil",1268,675,53.2,670,397,273,59.3
75619024033,"Mellingen",2811,1433,51,1421,799,622,56.2
75619024034,"Neuenhof",3800,1737,45.7,1730,988,742,57.1
75619024035,"Niederrohrdorf",2450,1453,59.3,1441,776,665,53.9
75619024037,"Oberrohrdorf",2743,1774,64.7,1757,835,922,47.5
75619024038,"Obersiggenthal",4816,2791,58,2762,1271,1491,46
75619024039,"Remetschwil",1408,814,57.8,810,435,375,53.7
75619024040,"Spreitenbach",4355,1854,42.6,1847,1212,635,65.6
75619024041,"Stetten (AG)",1236,622,50.3,616,350,266,56.8
75619024042,"Turgi",1513,774,51.2,763,351,412,46
75619024044,"Untersiggenthal",4113,2386,58,2371,1263,1108,53.3
75619024045,"Wettingen",12536,7101,56.6,7059,3270,3789,46.3
75619024046,"Wohlenschwil",1004,566,56.4,563,307,256,54.5
75619024047,"Würenlingen",2640,1467,55.6,1458,866,592,59.4
75619024048,"Würenlos",3975,2377,59.8,2361,1297,1064,54.9
75619024049,"Ehrendingen",2974,1646,55.3,1638,931,707,56.8
75619034061,"Arni (AG)",1284,789,61.4,779,390,389,50.1
75619034062,"Berikon",3047,1808,59.3,1793,1040,753,58
75619034063,"Bremgarten (AG)",4970,2649,53.3,2634,1374,1260,52.2
75619034064,"Büttikon",637,370,58.1,364,248,116,68.1
75619034065,"Dottikon",2047,1081,52.8,1074,677,397,63
75619034066,"Eggenwil",627,412,65.7,408,231,177,56.6
75619034067,"Fischbach-Göslikon",1140,591,51.8,587,374,213,63.7
75619034068,"Hägglingen",1618,921,56.9,915,571,344,62.4
75619034071,"Jonen",1333,818,61.4,811,442,369,54.5
75619034072,"Niederwil (AG)",1725,898,52.1,892,565,327,63.3
75619034073,"Oberlunkhofen",1395,862,61.8,857,471,386,55
75619034074,"Oberwil-Lieli",1575,980,62.2,976,531,445,54.4
75619034075,"Rudolfstetten-Friedlisberg",2726,1436,52.7,1428,828,600,58
75619034076,"Sarmenstorf",1869,976,52.2,970,639,331,65.9
75619034077,"Tägerig",921,528,57.3,527,333,194,63.2
75619034078,"Uezwil",303,204,67.3,202,136,66,67.3
75619034079,"Unterlunkhofen",929,568,61.1,567,340,227,60
75619034080,"Villmergen",4040,2103,52.1,2089,1439,650,68.9
75619034081,"Widen",2542,1722,67.7,1707,901,806,52.8
75619034082,"Wohlen (AG)",8143,4394,54,4366,2531,1835,58
75619034083,"Zufikon",2895,1710,59.1,1701,958,743,56.3
75619034084,"Islisberg",406,263,64.8,263,151,112,57.4
75619044091,"Auenstein",1188,697,58.7,688,359,329,52.2
75619044092,"Birr",1880,896,47.7,894,522,372,58.4
75619044093,"Birrhard",488,312,63.9,312,196,116,62.8
75619044094,"Bözen",515,292,56.7,291,185,106,63.6
75619044095,"Brugg",6761,3978,58.8,3932,1760,2172,44.8
75619044096,"Effingen",446,249,55.8,249,138,111,55.4
75619044097,"Elfingen",195,116,59.5,115,52,63,45.2
75619044099,"Habsburg",325,224,68.9,221,137,84,62
75619044100,"Hausen (AG)",2152,1233,57.3,1227,719,508,58.6
75619044104,"Lupfig",1465,854,58.3,850,525,325,61.8
75619044105,"Mandach",232,117,50.4,117,81,36,69.2
75619044106,"Mönthal",311,176,56.6,176,117,59,66.5
75619044107,"Mülligen",719,379,52.7,377,200,177,53.1
75619044110,"Remigen",741,459,61.9,457,269,188,58.9
75619044111,"Riniken",1011,599,59.2,594,304,290,51.2
75619044112,"Rüfenach",631,413,65.5,412,206,206,50
75619044113,"Scherz",478,298,62.3,295,175,120,59.3
75619044114,"Schinznach-Bad",718,465,64.8,459,267,192,58.2
75619044117,"Thalheim (AG)",614,336,54.7,334,217,117,65
75619044120,"Veltheim (AG)",960,510,53.1,504,302,202,59.9
75619044121,"Villigen",1276,775,60.7,769,441,328,57.3
75619044122,"Villnachern",1048,634,60.5,628,331,297,52.7
75619044123,"Windisch",3961,2176,54.9,2159,957,1202,44.3
75619044124,"Bözberg",1184,722,61,721,436,285,60.5
75619044125,"Schinznach",1562,924,59.2,913,505,408,55.3
75619054131,"Beinwil am See",2190,1234,56.3,1223,696,527,56.9
75619054132,"Birrwil",780,478,61.3,474,266,208,56.1
75619054133,"Burg (AG)",548,254,46.4,253,184,69,72.7
75619054134,"Dürrenäsch",874,526,60.2,520,395,125,76
75619054135,"Gontenschwil",1430,814,56.9,811,567,244,69.9
75619054136,"Holziken",902,440,48.8,438,326,112,74.4
75619054137,"Leimbach (AG)",323,207,64.1,204,132,72,64.7
75619054138,"Leutwil",553,340,61.5,339,260,79,76.7
75619054139,"Menziken",3048,1577,51.7,1565,1057,508,67.5
75619054140,"Oberkulm",1653,929,56.2,924,653,271,70.7
75619054141,"Reinach (AG)",4287,2092,48.8,2090,1417,673,67.8
75619054142,"Schlossrued",619,334,54,331,260,71,78.5
75619054143,"Schmiedrued",860,436,50.7,434,329,105,75.8
75619054144,"Schöftland",2829,1528,54,1508,903,605,59.9
75619054145,"Teufenthal (AG)",1019,518,50.8,516,315,201,61
75619054146,"Unterkulm",1777,972,54.7,970,634,336,65.4
75619054147,"Zetzwil",966,542,56.1,539,395,144,73.3
75619064161,"Eiken",1449,665,45.9,659,410,249,62.2
75619064163,"Frick",3187,1690,53,1679,888,791,52.9
75619064164,"Gansingen",755,470,62.3,468,272,196,58.1
75619064165,"Gipf-Oberfrick",2470,1457,59,1442,708,734,49.1
75619064166,"Herznach",974,566,58.1,562,336,226,59.8
75619064167,"Hornussen",613,345,56.3,341,210,131,61.6
75619064169,"Kaisten",1778,930,52.3,921,515,406,55.9
75619064170,"Laufenburg",1874,1065,56.8,1058,550,508,52
75619064172,"Münchwilen (AG)",587,334,56.9,331,200,131,60.4
75619064173,"Oberhof",429,267,62.2,265,171,94,64.5
75619064175,"Oeschgen",653,363,55.6,359,221,138,61.6
75619064176,"Schwaderloch",455,239,52.5,238,153,85,64.3
75619064177,"Sisseln",915,433,47.3,433,271,162,62.6
75619064179,"Ueken",562,306,54.4,304,186,118,61.2
75619064181,"Wittnau",878,499,56.8,497,265,232,53.3
75619064182,"Wölflinswil",701,424,60.5,421,255,166,60.6
75619064183,"Zeihen",756,429,56.7,429,270,159,62.9
75619064184,"Mettauertal",1418,815,57.5,814,483,331,59.3
75619074191,"Ammerswil",459,281,61.2,279,157,122,56.3
75619074192,"Boniswil",985,628,63.8,623,384,239,61.6
75619074193,"Brunegg",459,262,57.1,256,163,93,63.7
75619074194,"Dintikon",1286,724,56.3,722,483,239,66.9
75619074195,"Egliswil",974,551,56.6,547,323,224,59
75619074196,"Fahrwangen",1255,609,48.5,605,371,234,61.3
75619074197,"Hallwil",540,280,51.9,280,194,86,69.3
75619074198,"Hendschiken",683,361,52.9,360,218,142,60.6
75619074199,"Holderbank (AG)",614,321,52.3,321,236,85,73.5
75619074200,"Hunzenschwil",2135,1028,48.1,1024,694,330,67.8
75619074201,"Lenzburg",5410,3032,56,3004,1272,1732,42.3
75619074202,"Meisterschwanden",1882,1168,62.1,1160,675,485,58.2
75619074203,"Möriken-Wildegg",2755,1590,57.7,1576,887,689,56.3
75619074204,"Niederlenz",2539,1346,53,1336,672,664,50.3
75619074205,"Othmarsingen",1586,850,53.6,846,538,308,63.6
75619074206,"Rupperswil",3213,1722,53.6,1713,1030,683,60.1
75619074207,"Schafisheim",1909,1027,53.8,1023,638,385,62.4
75619074208,"Seengen",2615,1574,60.2,1562,912,650,58.4
75619074209,"Seon",3056,1721,56.3,1704,1045,659,61.3
75619074210,"Staufen",1784,1138,63.8,1128,595,533,52.7
75619084221,"Abtwil",643,327,50.9,327,206,121,63
75619084222,"Aristau",982,518,52.7,513,297,216,57.9
75619084223,"Auw",1178,538,45.7,536,335,201,62.5
75619084224,"Beinwil (Freiamt)",747,427,57.2,426,272,154,63.8
75619084226,"Besenbüren",416,242,58.2,240,156,84,65
75619084227,"Bettwil",424,252,59.4,250,160,90,64
75619084228,"Boswil",1789,944,52.8,939,602,337,64.1
75619084229,"Bünzen",701,396,56.5,392,252,140,64.3
75619084230,"Buttwil",837,481,57.5,474,293,181,61.8
75619084231,"Dietwil",874,459,52.5,456,318,138,69.7
75619084232,"Geltwil",132,76,57.6,73,36,37,49.3
75619084233,"Kallern",237,142,59.9,141,95,46,67.4
75619084234,"Merenschwand",2167,1292,59.6,1283,728,555,56.7
75619084235,"Mühlau",711,382,53.7,381,249,132,65.4
75619084236,"Muri (AG)",4572,2381,52.1,2369,1285,1084,54.2
75619084237,"Oberrüti",956,518,54.2,517,293,224,56.7
75619084238,"Rottenschwil",569,341,59.9,340,233,107,68.5
75619084239,"Sins",2651,1363,51.4,1355,841,514,62.1
75619084240,"Waltenschwil",1769,971,54.9,965,592,373,61.3
75619094251,"Hellikon",603,348,57.7,343,257,86,74.9
75619094252,"Kaiseraugst",3258,1634,50.2,1625,891,734,54.8
75619094253,"Magden",2602,1540,59.2,1529,741,788,48.5
75619094254,"Möhlin",6503,3223,49.6,3206,1849,1357,57.7
75619094255,"Mumpf",804,345,42.9,343,198,145,57.7
75619094256,"Obermumpf",719,354,49.2,353,204,149,57.8
75619094257,"Olsberg",280,168,60,167,85,82,50.9
75619094258,"Rheinfelden",7302,3750,51.4,3716,1706,2010,45.9
75619094259,"Schupfart",575,325,56.5,325,210,115,64.6
75619094260,"Stein (AG)",1578,730,46.3,724,426,298,58.8
75619094261,"Wallbach",1330,743,55.9,734,429,305,58.4
75619094262,"Wegenstetten",773,411,53.2,410,245,165,59.8
75619094263,"Zeiningen",1567,826,52.7,821,430,391,52.4
75619094264,"Zuzgen",611,323,52.9,319,199,120,62.4
75619104271,"Aarburg",3519,1721,48.9,1705,1028,677,60.3
75619104272,"Attelwil",224,157,70.1,157,121,36,77.1
75619104273,"Bottenwil",604,330,54.6,328,218,110,66.5
75619104274,"Brittnau",2779,1550,55.8,1541,946,595,61.4
75619104275,"Kirchleerau",594,346,58.2,344,247,97,71.8
75619104276,"Kölliken",2847,1477,51.9,1466,886,580,60.4
75619104277,"Moosleerau",619,344,55.6,344,244,100,70.9
75619104279,"Murgenthal",1956,957,48.9,951,647,304,68
75619104280,"Oftringen",7323,3444,47,3425,2134,1291,62.3
75619104281,"Reitnau",859,482,56.1,480,330,150,68.8
75619104282,"Rothrist",5377,2659,49.5,2646,1700,946,64.2
75619104283,"Safenwil",2457,1248,50.8,1244,837,407,67.3
75619104284,"Staffelbach",792,432,54.5,429,290,139,67.6
75619104285,"Strengelbach",2854,1548,54.2,1542,932,610,60.4
75619104286,"Uerkheim",994,534,53.7,529,373,156,70.5
75619104287,"Vordemwald",1403,754,53.7,749,464,285,61.9
75619104288,"Wiliberg",133,105,78.9,105,78,27,74.3
75619104289,"Zofingen",7731,4533,58.6,4492,2125,2367,47.3
75619114301,"Baldingen",205,121,59,117,82,35,70.1
75619114302,"Böbikon",123,73,59.3,73,56,17,76.7
75619114303,"Böttstein",1928,1039,53.9,1030,682,348,66.2
75619114304,"Döttingen",1975,1141,57.8,1129,682,447,60.4
75619114305,"Endingen",1569,928,59.1,921,477,444,51.8
75619114306,"Fisibach",245,145,59.2,145,98,47,67.6
75619114307,"Full-Reuenthal",566,319,56.4,319,204,115,63.9
75619114308,"Kaiserstuhl",254,148,58.3,148,60,88,40.5
75619114309,"Klingnau",2005,1130,56.4,1121,637,484,56.8
75619114310,"Koblenz",792,433,54.7,429,265,164,61.8
75619114311,"Leibstadt",748,444,59.4,442,301,141,68.1
75619114312,"Lengnau (AG)",1716,1010,58.9,1004,614,390,61.2
75619114313,"Leuggern",1457,881,60.5,878,614,264,69.9
75619114314,"Mellikon",168,99,58.9,95,50,45,52.6
75619114315,"Rekingen (AG)",566,306,54.1,301,215,86,71.4
75619114316,"Rietheim",377,193,51.2,193,109,84,56.5
75619114317,"Rümikon",167,92,55.1,92,61,31,66.3
75619114318,"Schneisingen",982,598,60.9,597,346,251,58
75619114319,"Siglistorf",396,218,55.1,218,154,64,70.6
75619114320,"Tegerfelden",770,433,56.2,430,264,166,61.4
75619114322,"Wislikofen",257,155,60.3,152,65,87,42.8
75619114323,"Bad Zurzach",2243,1218,54.3,1211,664,547,54.8
75620114401,"Arbon",8211,3861,47,3741,2112,1629,56.5
75620114406,"Dozwil",435,281,64.6,275,195,80,70.9
75620114411,"Egnach",3074,1700,55.3,1666,967,699,58
75620114416,"Hefenhofen",848,445,52.5,438,275,163,62.8
75620114421,"Horn",1785,929,52,914,509,405,55.7
75620114426,"Kesswil",651,427,65.6,423,220,203,52
75620114431,"Roggwil (TG)",1947,1094,56.2,1059,647,412,61.1
75620114436,"Romanshorn",6195,3116,50.3,3052,1679,1373,55
75620114441,"Salmsach",818,404,49.4,399,232,167,58.1
75620114446,"Sommeri",374,221,59.1,218,151,67,69.3
75620114451,"Uttwil",1207,707,58.6,699,405,294,57.9
75620114461,"Amriswil",7406,3416,46.1,3334,2034,1300,61
75620154471,"Bischofszell",3502,1791,51.1,1749,1029,720,58.8
75620154476,"Erlen",2028,989,48.8,964,622,342,64.5
75620154486,"Hauptwil-Gottshaus",1341,719,53.6,703,454,249,64.6
75620154495,"Hohentannen",429,243,56.6,239,174,65,72.8
75620154501,"Kradolf-Schönenberg",2159,1096,50.8,1073,678,395,63.2
75620154506,"Sulgen",2297,1243,54.1,1228,752,476,61.2
75620154511,"Zihlschlacht-Sitterdorf",1496,848,56.7,816,529,287,64.8
75620124536,"Basadingen-Schlattingen",1204,734,61,710,488,222,68.7
75620124545,"Diessenhofen",2026,1138,56.2,1130,666,464,58.9
75620124546,"Schlatt (TG)",1150,655,57,650,422,228,64.9
75620144551,"Aadorf",5810,3099,53.3,2941,1742,1199,59.2
75620124561,"Felben-Wellhausen",1700,827,48.6,798,499,299,62.5
75620124566,"Frauenfeld",15548,8521,54.8,8321,4044,4277,48.6
75620124571,"Gachnang",2444,1398,57.2,1321,767,554,58.1
75620124590,"Hüttlingen",605,359,59.3,351,206,145,58.7
75620124591,"Matzingen",1591,787,49.5,768,456,312,59.4
75620124601,"Neunforn",745,440,59.1,434,267,167,61.5
75620124606,"Stettfurt",812,494,60.8,485,254,231,52.4
75620124611,"Thundorf",988,549,55.6,530,328,202,61.9
75620124616,"Uesslingen-Buch",813,499,61.4,482,307,175,63.7
75620124621,"Warth-Weiningen",914,552,60.4,539,340,199,63.1
75620134641,"Altnau",1367,698,51.1,688,358,330,52
75620134643,"Bottighofen",1237,775,62.7,760,370,390,48.7
75620134646,"Ermatingen",1857,1027,55.3,1003,512,491,51
75620134651,"Gottlieben",157,107,68.2,105,46,59,43.8
75620134656,"Güttingen",973,600,61.7,592,341,251,57.6
75620134666,"Kemmental",1524,844,55.4,813,525,288,64.6
75620134671,"Kreuzlingen",8402,4559,54.3,4443,2184,2259,49.2
75620134681,"Langrickenbach",828,488,58.9,473,308,165,65.1
75620134683,"Lengwil",912,507,55.6,494,304,190,61.5
75620134691,"Münsterlingen",1598,874,54.7,866,450,416,52
75620134696,"Tägerwilen",2248,1185,52.7,1120,575,545,51.3
75620134701,"Wäldi",687,391,56.9,388,274,114,70.6
75620154711,"Affeltrangen",1614,940,58.2,922,654,268,70.9
75620144716,"Bettwiesen",708,373,52.7,367,249,118,67.8
75620144721,"Bichelsee-Balterswil",1926,1059,55,1027,632,395,61.5
75620144723,"Braunau",501,289,57.7,283,172,111,60.8
75620144724,"Eschlikon",2956,1650,55.8,1632,943,689,57.8
75620144726,"Fischingen",1873,1058,56.5,1041,688,353,66.1
75620144741,"Lommis",805,483,60,463,308,155,66.5
75620144746,"Münchwilen (TG)",3167,1579,49.9,1525,913,612,59.9
75620144751,"Rickenbach (TG)",1563,765,48.9,750,449,301,59.9
75620154756,"Schönholzerswilen",575,312,54.3,311,199,112,64
75620144761,"Sirnach",4643,2432,52.4,2369,1455,914,61.4
75620144776,"Tobel-Tägerschen",984,546,55.5,523,374,149,71.5
75620144781,"Wängi",2988,1653,55.3,1592,1008,584,63.3
75620144786,"Wilen (TG)",1529,834,54.5,824,438,386,53.2
75620154791,"Wuppenau",791,442,55.9,438,287,151,65.5
75620124801,"Berlingen",570,365,64,352,172,180,48.9
75620124806,"Eschenz",1158,633,54.7,628,389,239,61.9
75620124811,"Herdern",713,450,63.1,436,251,185,57.6
75620124816,"Homburg",1089,617,56.7,610,426,184,69.8
75620124821,"Hüttwilen",1129,706,62.5,688,339,349,49.3
75620124826,"Mammern",364,220,60.4,214,120,94,56.1
75620124831,"Müllheim",1887,883,46.8,849,535,314,63
75620124841,"Pfyn",1337,742,55.5,734,516,218,70.3
75620134846,"Raperswilen",289,195,67.5,194,160,34,82.5
75620134851,"Salenstein",805,485,60.2,476,254,222,53.4
75620124864,"Steckborn",2266,1209,53.4,1153,594,559,51.5
75620124871,"Wagenhausen",1086,605,55.7,583,369,214,63.3
75620154881,"Amlikon-Bissegg",972,567,58.3,562,396,166,70.5
75620154891,"Berg (TG)",2215,1235,55.8,1203,717,486,59.6
75620154901,"Birwinken",940,558,59.4,544,378,166,69.5
75620154911,"Bürglen (TG)",2163,1111,51.4,1087,698,389,64.2
75620154921,"Bussnang",1522,853,56,850,579,271,68.1
75620154941,"Märstetten",1883,1025,54.4,1006,591,415,58.7
75620154946,"Weinfelden",7229,3950,54.6,3840,1966,1874,51.2
75620154951,"Wigoltingen",1567,872,55.6,850,551,299,64.8
75621015001,"Arbedo-Castione",2658,1574,59.2,1553,1094,459,70.4
75621015002,"Bellinzona",10683,5637,52.8,5537,3315,2222,59.9
75621015003,"Cadenazzo",1271,598,47,583,422,161,72.4
75621015004,"Camorino",1803,1059,58.7,1031,700,331,67.9
75621015005,"Giubiasco",5163,2834,54.9,2784,1855,929,66.6
75621015006,"Gnosca",480,277,57.7,275,200,75,72.7
75621015007,"Gorduno",506,261,51.6,258,164,94,63.6
75621015008,"Gudo",563,296,52.6,292,202,90,69.2
75621015009,"Isone",320,196,61.3,194,175,19,90.2
75621015010,"Lumino",923,537,58.2,527,387,140,73.4
75621015012,"Moleno",82,64,78,63,44,19,69.8
75621015013,"Monte Carasso",1754,944,53.8,930,655,275,70.4
75621015014,"Pianezzo",458,268,58.5,262,162,100,61.8
75621015015,"Preonzo",450,242,53.8,238,148,90,62.2
75621015017,"Sant'Antonino",1323,728,55,712,550,162,77.2
75621015018,"Sant'Antonio",186,107,57.5,107,71,36,66.4
75621015019,"Sementina",1899,1100,57.9,1086,763,323,70.3
75621025048,"Acquarossa",1427,615,43.1,605,420,185,69.4
75621025049,"Blenio",1397,677,48.5,665,483,182,72.6
75621025050,"Serravalle",1783,938,52.6,923,690,233,74.8
75621035061,"Airolo",1042,593,56.9,584,429,155,73.5
75621035063,"Bedretto",84,55,65.5,55,40,15,72.7
75621035064,"Bodio",460,245,53.3,245,179,66,73.1
75621035071,"Dalpe",161,110,68.3,108,78,30,72.2
75621035072,"Faido",2096,1216,58,1201,792,409,65.9
75621035073,"Giornico",542,285,52.6,283,205,78,72.4
75621035076,"Personico",228,131,57.5,122,73,49,59.8
75621035077,"Pollegio",403,231,57.3,228,161,67,70.6
75621035078,"Prato (Leventina)",270,165,61.1,164,109,55,66.5
75621035079,"Quinto",739,389,52.6,385,258,127,67
75621035081,"Sobrio",61,32,52.5,32,25,7,78.1
75621045091,"Ascona",3418,1854,54.2,1832,1143,689,62.4
75621045095,"Brione (Verzasca)",162,75,46.3,71,48,23,67.6
75621045096,"Brione sopra Minusio",403,236,58.6,235,148,87,63
75621045097,"Brissago",1337,730,54.6,705,470,235,66.7
75621045102,"Corippo",14,7,50,7,5,2,71.4
75621045105,"Frasco",102,54,52.9,50,38,12,76
75621045108,"Gordola",3037,1569,51.7,1544,1051,493,68.1
75621045109,"Gresso",46,29,63,29,23,6,79.3
75621045112,"Lavertezzo",763,396,51.9,391,272,119,69.6
75621045113,"Locarno",9318,4260,45.7,4208,2655,1553,63.1
75621045115,"Losone",4247,2323,54.7,2290,1544,746,67.4
75621045117,"Mergoscia",170,107,62.9,102,59,43,57.8
75621045118,"Minusio",4791,2755,57.5,2709,1646,1063,60.8
75621045119,"Mosogno",51,25,49,25,11,14,44
75621045120,"Muralto",1847,977,52.9,967,599,368,61.9
75621045121,"Orselina",557,340,61,335,192,143,57.3
75621045125,"Ronco sopra Ascona",464,296,63.8,293,191,102,65.2
75621045129,"Sonogno",96,41,42.7,41,25,16,61
75621045131,"Tenero-Contra",1671,880,52.7,872,557,315,63.9
75621045132,"Vergeletto",62,37,59.7,36,23,13,63.9
75621045135,"Vogorno",242,104,43,102,70,32,68.6
75621045136,"Onsernone",345,119,34.5,117,62,55,53
75621045137,"Isorno",276,124,44.9,122,47,75,38.5
75621045138,"Cugnasco-Gerra",1949,1128,57.9,1115,800,315,71.7
75621055141,"Agno",2454,1356,55.3,1340,993,347,74.1
75621055143,"Aranno",231,130,56.3,127,65,62,51.2
75621055144,"Arogno",710,418,58.9,406,284,122,70
75621055146,"Astano",243,141,58,135,85,50,63
75621055148,"Bedano",981,588,59.9,584,429,155,73.5
75621055149,"Bedigliora",502,260,51.8,256,160,96,62.5
75621055151,"Bioggio",1733,1093,63.1,1081,776,305,71.8
75621055154,"Bissone",527,297,56.4,292,204,88,69.9
75621055160,"Brusino Arsizio",384,226,58.9,222,151,71,68
75621055161,"Cademario",487,284,58.3,282,195,87,69.1
75621055162,"Cadempino",900,555,61.7,554,414,140,74.7
75621055167,"Canobbio",1326,815,61.5,802,579,223,72.2
75621055171,"Caslano",2559,1510,59,1495,1046,449,70
75621055176,"Comano",1489,997,67,985,615,370,62.4
75621055178,"Croglio",663,377,56.9,374,254,120,67.9
75621055180,"Cureglia",930,607,65.3,602,374,228,62.1
75621055181,"Curio",426,281,66,278,196,82,70.5
75621055186,"Grancia",298,179,60.1,176,145,31,82.4
75621055187,"Gravesano",830,487,58.7,482,357,125,74.1
75621055189,"Lamone",868,498,57.4,485,357,128,73.6
75621055192,"Lugano",34202,19623,57.4,19368,13036,6332,67.3
75621055193,"Magliaso",1002,607,60.6,596,458,138,76.8
75621055194,"Manno",856,559,65.3,550,384,166,69.8
75621055195,"Maroggia",361,221,61.2,217,155,62,71.4
75621055196,"Massagno",3156,1830,58,1791,1073,718,59.9
75621055197,"Melano",843,473,56.1,468,342,126,73.1
75621055198,"Melide",975,593,60.8,585,374,211,63.9
75621055199,"Mezzovico-Vira",862,550,63.8,546,439,107,80.4
75621055200,"Miglieglia",195,105,53.8,100,78,22,78
75621055202,"Monteggio",622,391,62.9,388,308,80,79.4
75621055203,"Morcote",396,226,57.1,218,140,78,64.2
75621055205,"Muzzano",570,385,67.5,380,254,126,66.8
75621055206,"Neggio",271,176,64.9,172,117,55,68
75621055207,"Novaggio",612,425,69.4,408,248,160,60.8
75621055208,"Origlio",947,635,67.1,619,380,239,61.4
75621055210,"Paradiso",1597,818,51.2,789,537,252,68.1
75621055212,"Ponte Capriasca",1206,764,63.3,757,535,222,70.7
75621055213,"Ponte Tresa",522,300,57.5,296,205,91,69.3
75621055214,"Porza",994,632,63.6,620,408,212,65.8
75621055216,"Pura",946,588,62.2,580,408,172,70.3
75621055219,"Rovio",551,376,68.2,368,264,104,71.7
75621055221,"Savosa",1217,749,61.5,737,516,221,70
75621055222,"Sessa",504,343,68.1,338,241,97,71.3
75621055225,"Sorengo",985,663,67.3,651,394,257,60.5
75621055226,"Capriasca",4739,2852,60.2,2793,1837,956,65.8
75621055227,"Torricella-Taverne",1769,1064,60.1,1041,794,247,76.3
75621055230,"Vernate",387,247,63.8,245,161,84,65.7
75621055231,"Vezia",1177,707,60.1,701,473,228,67.5
75621055233,"Vico Morcote",176,115,65.3,114,80,34,70.2
75621055236,"Collina d'Oro",2703,1729,64,1701,1183,518,69.5
75621055237,"Alto Malcantone",1069,598,55.9,586,391,195,66.7
75621055238,"Monteceneri",2841,1581,55.6,1549,1223,326,79
75621065242,"Balerna",2241,1353,60.4,1327,958,369,72.2
75621065249,"Castel San Pietro",1568,1063,67.8,1043,738,305,70.8
75621065250,"Chiasso",4509,2502,55.5,2477,1784,693,72
75621065251,"Coldrerio",1872,1242,66.3,1230,913,317,74.2
75621065254,"Mendrisio",10106,6279,62.1,6090,4197,1893,68.9
75621065257,"Morbio Inferiore",2976,1860,62.5,1834,1334,500,72.7
75621065260,"Novazzano",1750,1181,67.5,1165,916,249,78.6
75621065263,"Riva San Vitale",1828,1129,61.8,1122,825,297,73.5
75621065266,"Stabio",2908,1883,64.8,1855,1352,503,72.9
75621065268,"Vacallo",2057,1248,60.7,1236,852,384,68.9
75621065269,"Breggia",1568,961,61.3,948,650,298,68.6
75621075281,"Biasca",3284,1715,52.2,1690,1277,413,75.6
75621075282,"Claro",1778,960,54,940,698,242,74.3
75621075283,"Cresciano",371,191,51.5,189,160,29,84.7
75621075284,"Iragna",347,177,51,175,127,48,72.6
75621075285,"Lodrino",996,584,58.6,579,395,184,68.2
75621075286,"Osogna",550,282,51.3,277,206,71,74.4
75621085304,"Bosco/Gurin",46,21,45.7,16,9,7,56.3
75621085307,"Campo (Vallemaggia)",57,24,42.1,24,15,9,62.5
75621085309,"Cerentino",51,20,39.2,20,8,12,40
75621085310,"Cevio",855,425,49.7,414,264,150,63.8
75621085315,"Linescio",45,25,55.6,24,16,8,66.7
75621085317,"Maggia",1851,949,51.3,937,623,314,66.5
75621085323,"Lavizzara",464,200,43.1,197,142,55,72.1
75621085324,"Avegno Gordevio",1086,642,59.1,632,404,228,63.9
75621015391,"Comunanza Cadenazzo/Monteceneri",NA,NA,NA,NA,NA,NA,NA
75621055394,"Comunanza Capriasca/Lugano",NA,NA,NA,NA,NA,NA,NA
75621045396,"Terre di Pedemonte",1843,1128,61.2,1110,657,453,59.2
75621045397,"Centovalli",963,480,49.8,472,315,157,66.7
75621045398,"Gambarogno",3505,1790,51.1,1758,1174,584,66.8
75622215401,"Aigle",4886,2701,55.3,2657,1199,1458,45.1
75622215402,"Bex",3944,2210,56,2168,995,1173,45.9
75622215403,"Chessel",245,174,71,169,87,82,51.5
75622215404,"Corbeyrier",299,197,65.9,190,98,92,51.6
75622215405,"Gryon",698,406,58.2,402,191,211,47.5
75622215406,"Lavey-Morcles",582,343,58.9,340,185,155,54.4
75622215407,"Leysin",1267,687,54.2,678,276,402,40.7
75622215408,"Noville",550,321,58.4,320,145,175,45.3
75622215409,"Ollon",3723,2298,61.7,2263,969,1294,42.8
75622215410,"Ormont-Dessous",746,411,55.1,401,216,185,53.9
75622215411,"Ormont-Dessus",965,560,58,551,235,316,42.6
75622215412,"Rennaz",411,203,49.4,203,90,113,44.3
75622215413,"Roche (VD)",775,400,51.6,396,215,181,54.3
75622215414,"Villeneuve (VD)",2500,1340,53.6,1319,647,672,49.1
75622215415,"Yvorne",721,446,61.9,437,176,261,40.3
75622275421,"Apples",853,562,65.9,553,176,377,31.8
75622275422,"Aubonne",1693,1063,62.8,1046,347,699,33.2
75622275423,"Ballens",327,225,68.8,221,96,125,43.4
75622275424,"Berolle",193,119,61.7,114,40,74,35.1
75622275425,"Bière",952,531,55.8,524,257,267,49
75622275426,"Bougy-Villars",252,167,66.3,163,65,98,39.9
75622275427,"Féchy",483,334,69.2,326,130,196,39.9
75622275428,"Gimel",1106,621,56.1,612,275,337,44.9
75622285429,"Longirod",285,193,67.7,191,76,115,39.8
75622285430,"Marchissy",292,176,60.3,174,51,123,29.3
75622275431,"Mollens (VD)",198,119,60.1,117,52,65,44.4
75622275432,"Montherod",271,172,63.5,170,62,108,36.5
75622285434,"Saint-George",553,368,66.5,359,132,227,36.8
75622275435,"Saint-Livres",445,269,60.4,266,113,153,42.5
75622275436,"Saint-Oyens",209,140,67,136,66,70,48.5
75622275437,"Saubraz",216,112,51.9,107,57,50,53.3
75622225451,"Avenches",2012,1041,51.7,1030,485,545,47.1
75622225456,"Cudrefin",958,558,58.2,552,238,314,43.1
75622225458,"Faoug",528,278,52.7,272,119,153,43.8
75622225464,"Vully-les-Lacs",1921,1122,58.4,1102,501,601,45.5
75622235471,"Bettens",270,169,62.6,166,69,97,41.6
75622235472,"Bournens",218,145,66.5,141,69,72,48.9
75622235473,"Boussens",593,376,63.4,370,182,188,49.2
75622275474,"La Chaux (Cossonay)",283,175,61.8,173,59,114,34.1
75622275475,"Chavannes-le-Veyron",85,61,71.8,61,23,38,37.7
75622275476,"Chevilly",167,99,59.3,94,23,71,24.5
75622275477,"Cossonay",2067,1219,59,1199,424,775,35.4
75622275478,"Cottens (VD)",306,215,70.3,214,87,127,40.7
75622275479,"Cuarnens",283,189,66.8,188,67,121,35.6
75622235480,"Daillens",565,362,64.1,359,144,215,40.1
75622275481,"Dizy",153,105,68.6,100,40,60,40
75622275482,"Eclépens",633,417,65.9,410,186,224,45.4
75622275483,"Ferreyres",207,138,66.7,137,45,92,32.8
75622275484,"Gollion",528,329,62.3,327,141,186,43.1
75622275485,"Grancy",269,180,66.9,176,50,126,28.4
75622275486,"L'Isle",720,401,55.7,385,167,218,43.4
75622235487,"Lussery-Villars",273,170,62.3,157,60,97,38.2
75622275488,"Mauraz",41,31,75.6,31,13,18,41.9
75622235489,"Mex (VD)",420,275,65.5,270,135,135,50
75622275490,"Moiry",187,127,67.9,126,51,75,40.5
75622275491,"Mont-la-Ville",252,163,64.7,157,55,102,35
75622275492,"Montricher",598,402,67.2,399,159,240,39.8
75622275493,"Orny",235,125,53.2,122,35,87,28.7
75622275494,"Pampigny",712,406,57,399,169,230,42.4
75622235495,"Penthalaz",1848,1102,59.6,1084,485,599,44.7
75622235496,"Penthaz",1013,607,59.9,601,259,342,43.1
75622275497,"Pompaples",475,242,50.9,236,94,142,39.8
75622275498,"La Sarraz",1398,825,59,803,314,489,39.1
75622275499,"Senarclens",299,200,66.9,193,87,106,45.1
75622275500,"Sévery",152,98,64.5,96,43,53,44.8
75622235501,"Sullens",620,392,63.2,388,200,188,51.5
75622235503,"Vufflens-la-Ville",820,556,67.8,546,218,328,39.9
75622235511,"Assens",703,499,71,496,199,297,40.1
75622235512,"Bercher",743,427,57.5,419,165,254,39.4
75622235513,"Bioley-Orjulaz",270,178,65.9,173,95,78,54.9
75622235514,"Bottens",826,469,56.8,458,222,236,48.5
75622235515,"Bretigny-sur-Morrens",512,302,59,297,137,160,46.1
75622235516,"Cugy (VD)",1568,1006,64.2,991,359,632,36.2
75622235518,"Echallens",3293,1905,57.8,1873,802,1071,42.8
75622235520,"Essertines-sur-Yverdon",610,364,59.7,360,179,181,49.7
75622235521,"Etagnières",639,380,59.5,371,146,225,39.4
75622235522,"Fey",416,264,63.5,263,100,163,38
75622235523,"Froideville",1361,890,65.4,877,395,482,45
75622235527,"Morrens (VD)",694,461,66.4,451,178,273,39.5
75622235529,"Oulens-sous-Echallens",380,244,64.2,241,101,140,41.9
75622235530,"Pailly",338,195,57.7,194,100,94,51.5
75622235531,"Penthéréaz",275,177,64.4,176,78,98,44.3
75622235533,"Poliez-Pittet",515,297,57.7,291,141,150,48.5
75622235534,"Rueyres",169,106,62.7,105,49,56,46.7
75622235535,"Saint-Barthélemy (VD)",514,305,59.3,299,129,170,43.1
75622235537,"Villars-le-Terroir",631,403,63.9,397,197,200,49.6
75622235539,"Vuarrens",557,295,53,291,121,170,41.6
75622235540,"Montilliez",1040,637,61.3,630,290,340,46
75622235541,"Goumoëns",623,398,63.9,393,184,209,46.8
75622245551,"Bonvillars",360,241,66.9,241,115,126,47.7
75622245552,"Bullet",476,265,55.7,261,124,137,47.5
75622245553,"Champagne",626,364,58.1,358,146,212,40.8
75622245554,"Concise",618,393,63.6,388,158,230,40.7
75622245555,"Corcelles-près-Concise",229,144,62.9,140,37,103,26.4
75622245556,"Fiez",265,177,66.8,172,65,107,37.8
75622245557,"Fontaines-sur-Grandson",109,64,58.7,63,32,31,50.8
75622245559,"Giez",273,159,58.2,155,61,94,39.4
75622245560,"Grandevent",163,119,73,117,53,64,45.3
75622245561,"Grandson",2084,1199,57.5,1182,461,721,39
75622245562,"Mauborget",74,52,70.3,51,27,24,52.9
75622245563,"Mutrux",103,55,53.4,54,16,38,29.6
75622245564,"Novalles",81,49,60.5,49,22,27,44.9
75622245565,"Onnens (VD)",330,189,57.3,189,65,124,34.4
75622245566,"Provence",263,143,54.4,140,62,78,44.3
75622245568,"Sainte-Croix",3164,1697,53.6,1675,759,916,45.3
75622245571,"Tévenon",526,301,57.2,294,112,182,38.1
75622265581,"Belmont-sur-Lausanne",1984,1322,66.6,1298,450,848,34.7
75622255582,"Cheseaux-sur-Lausanne",2487,1518,61,1491,566,925,38
75622295583,"Crissier",3193,1781,55.8,1749,714,1035,40.8
75622255584,"Epalinges",5122,3290,64.2,3239,1066,2173,32.9
75622255585,"Jouxtens-Mézery",851,642,75.4,630,191,439,30.3
75622255586,"Lausanne",63350,35333,55.8,34795,11319,23476,32.5
75622255587,"Le Mont-sur-Lausanne",4034,2468,61.2,2422,923,1499,38.1
75622265588,"Paudex",807,504,62.5,495,157,338,31.7
75622295589,"Prilly",5718,3125,54.7,3058,1266,1792,41.4
75622265590,"Pully",10189,6561,64.4,6428,2029,4399,31.6
75622295591,"Renens (VD)",7925,3961,50,3888,1656,2232,42.6
75622255592,"Romanel-sur-Lausanne",2049,1225,59.8,1210,551,659,45.5
75622265601,"Chexbres",1361,857,63,844,312,532,37
75622265604,"Forel (Lavaux)",1317,822,62.4,804,352,452,43.8
75622265606,"Lutry",5808,3792,65.3,3727,1182,2545,31.7
75622265607,"Puidoux",1580,984,62.3,959,403,556,42
75622265609,"Rivaz",235,170,72.3,169,52,117,30.8
75622265610,"Saint-Saphorin (Lavaux)",233,171,73.4,164,44,120,26.8
75622265611,"Savigny",2069,1352,65.3,1324,548,776,41.4
75622265613,"Bourg-en-Lavaux",3317,2286,68.9,2245,663,1582,29.5
75622275621,"Aclens",309,192,62.1,190,64,126,33.7
75622275622,"Bremblens",309,202,65.4,200,66,134,33
75622275623,"Buchillon",391,271,69.3,265,122,143,46
75622295624,"Bussigny-près-Lausanne",4249,2499,58.8,2462,1060,1402,43.1
75622275625,"Bussy-Chardonney",235,169,71.9,165,53,112,32.1
75622295627,"Chavannes-près-Renens",2732,1507,55.2,1472,627,845,42.6
75622275628,"Chigny",197,125,63.5,124,51,73,41.1
75622275629,"Clarmont",105,72,68.6,71,26,45,36.6
75622275631,"Denens",440,274,62.3,271,83,188,30.6
75622275632,"Denges",878,540,61.5,534,195,339,36.5
75622275633,"Echandens",1443,954,66.1,934,365,569,39.1
75622275634,"Echichens",1658,1044,63,1028,367,661,35.7
75622295635,"Ecublens (VD)",5290,2953,55.8,2901,1320,1581,45.5
75622275636,"Etoy",1418,860,60.6,845,269,576,31.8
75622275637,"Lavigny",482,315,65.4,307,102,205,33.2
75622275638,"Lonay",1518,961,63.3,949,347,602,36.6
75622275639,"Lully (VD)",470,309,65.7,305,85,220,27.9
75622275640,"Lussy-sur-Morges",402,254,63.2,252,48,204,19
75622275642,"Morges",8352,4890,58.5,4787,1694,3093,35.4
75622275643,"Préverenges",2842,1692,59.5,1665,645,1020,38.7
75622275644,"Reverolle",245,151,61.6,149,65,84,43.6
75622275645,"Romanel-sur-Morges",329,223,67.8,222,81,141,36.5
75622275646,"Saint-Prex",2694,1587,58.9,1559,546,1013,35
75622295648,"Saint-Sulpice (VD)",1721,1154,67.1,1129,434,695,38.4
75622275649,"Tolochenaz",991,586,59.1,577,237,340,41.1
75622275650,"Vaux-sur-Morges",116,92,79.3,90,24,66,26.7
75622295651,"Villars-Sainte-Croix",418,277,66.3,273,135,138,49.5
75622275652,"Villars-sous-Yens",374,262,70.1,259,82,177,31.7
75622275653,"Vufflens-le-Château",498,381,76.5,373,160,213,42.9
75622275654,"Vullierens",320,210,65.6,206,64,142,31.1
75622275655,"Yens",753,514,68.3,504,187,317,37.1
75622235661,"Boulens",217,129,59.4,129,62,67,48.1
75622225662,"Brenles",111,80,72.1,80,44,36,55
75622225663,"Bussy-sur-Moudon",149,90,60.4,90,46,44,51.1
75622225665,"Chavannes-sur-Moudon",162,101,62.3,100,57,43,57
75622225666,"Chesalles-sur-Moudon",124,67,54,66,34,32,51.5
75622225668,"Cremin",39,25,64.1,25,15,10,60
75622225669,"Curtilles",219,138,63,138,59,79,42.8
75622225671,"Dompierre (VD)",184,121,65.8,119,63,56,52.9
75622225672,"Forel-sur-Lucens",115,79,68.7,74,32,42,43.2
75622225673,"Hermenches",243,130,53.5,129,71,58,55
75622225674,"Lovatens",106,69,65.1,67,32,35,47.8
75622225675,"Lucens",1522,750,49.3,737,373,364,50.6
75622225678,"Moudon",2540,1202,47.3,1188,611,577,51.4
75622235680,"Ogens",179,127,70.9,126,74,52,58.7
75622225683,"Prévonloup",102,59,57.8,59,21,38,35.6
75622225684,"Rossenges",41,28,68.3,28,15,13,53.6
75622225686,"Sarzens",56,39,69.6,39,16,23,41
75622225688,"Syens",84,55,65.5,53,32,21,60.4
75622225690,"Villars-le-Comte",121,68,56.2,67,41,26,61.2
75622225692,"Vucherens",360,235,65.3,228,115,113,50.4
75622235693,"Montanaire",1644,1024,62.3,1009,502,507,49.8
75622285701,"Arnex-sur-Nyon",118,87,73.7,87,25,62,28.7
75622285702,"Arzier",1342,806,60.1,786,329,457,41.9
75622285703,"Bassins",721,468,64.9,455,167,288,36.7
75622285704,"Begnins",959,588,61.3,581,201,380,34.6
75622285705,"Bogis-Bossey",442,281,63.6,277,91,186,32.9
75622285706,"Borex",493,337,68.4,330,106,224,32.1
75622285707,"Chavannes-de-Bogis",581,336,57.8,329,159,170,48.3
75622285708,"Chavannes-des-Bois",367,237,64.6,236,80,156,33.9
75622285709,"Chéserex",725,461,63.6,452,168,284,37.2
75622285710,"Coinsins",254,172,67.7,168,84,84,50
75622285711,"Commugny",1310,844,64.4,838,318,520,37.9
75622285712,"Coppet",1428,874,61.2,869,315,554,36.2
75622285713,"Crans-près-Céligny",1127,753,66.8,746,257,489,34.5
75622285714,"Crassier",571,388,68,380,135,245,35.5
75622285715,"Duillier",614,397,64.7,382,119,263,31.2
75622285716,"Eysins",722,428,59.3,427,155,272,36.3
75622285717,"Founex",1434,885,61.7,879,279,600,31.7
75622285718,"Genolier",981,680,69.3,672,231,441,34.4
75622285719,"Gingins",676,424,62.7,418,157,261,37.6
75622285720,"Givrins",552,382,69.2,372,127,245,34.1
75622285721,"Gland",6166,3469,56.3,3394,1360,2034,40.1
75622285722,"Grens",210,147,70,143,38,105,26.6
75622285723,"Mies",879,538,61.2,527,176,351,33.4
75622285724,"Nyon",9562,5492,57.4,5408,1957,3451,36.2
75622285725,"Prangins",2192,1398,63.8,1374,428,946,31.1
75622285726,"La Rippe",614,359,58.5,355,115,240,32.4
75622285727,"Saint-Cergue",1290,648,50.2,642,294,348,45.8
75622285728,"Signy-Avenex",279,184,65.9,179,59,120,33
75622285729,"Tannay",776,512,66,498,163,335,32.7
75622285730,"Trélex",785,532,67.8,521,166,355,31.9
75622285731,"Le Vaud",760,493,64.9,486,178,308,36.6
75622285732,"Vich",445,282,63.4,281,110,171,39.1
75622245741,"L'Abergement",168,114,67.9,111,49,62,44.1
75622245742,"Agiez",189,123,65.1,120,49,71,40.8
75622245743,"Arnex-sur-Orbe",430,276,64.2,269,107,162,39.8
75622245744,"Ballaigues",665,403,60.6,386,163,223,42.2
75622245745,"Baulmes",682,422,61.9,417,175,242,42
75622245746,"Bavois",574,320,55.7,314,145,169,46.2
75622245747,"Bofflens",137,86,62.8,85,44,41,51.8
75622245748,"Bretonnières",167,116,69.5,112,52,60,46.4
75622245749,"Chavornay",2223,1257,56.5,1243,570,673,45.9
75622245750,"Les Clées",115,92,80,89,22,67,24.7
75622245751,"Corcelles-sur-Chavornay",237,162,68.4,159,57,102,35.8
75622245752,"Croy",241,139,57.7,135,52,83,38.5
75622245754,"Juriens",231,150,64.9,144,60,84,41.7
75622245755,"Lignerolle",258,152,58.9,148,77,71,52
75622245756,"Montcherand",325,186,57.2,182,91,91,50
75622245757,"Orbe",3586,1887,52.6,1841,841,1000,45.7
75622245758,"La Praz",110,80,72.7,78,38,40,48.7
75622245759,"Premier",156,107,68.6,102,37,65,36.3
75622245760,"Rances",305,204,66.9,201,100,101,49.8
75622245761,"Romainmôtier-Envy",344,227,66,223,92,131,41.3
75622245762,"Sergey",99,60,60.6,58,36,22,62.1
75622245763,"Valeyres-sous-Rances",363,239,65.8,235,101,134,43
75622245764,"Vallorbe",2070,1134,54.8,1111,528,583,47.5
75622245765,"Vaulion",348,221,63.5,215,98,117,45.6
75622245766,"Vuiteboeuf",330,195,59.1,191,98,93,51.3
75622225782,"Carrouge (VD)",660,382,57.9,372,144,228,38.7
75622225785,"Corcelles-le-Jorat",315,210,66.7,209,99,110,47.4
75622265788,"Essertes",203,140,69,130,53,77,40.8
75622265789,"Ferlens (VD)",247,158,64,154,70,84,45.5
75622265790,"Maracon",323,212,65.6,208,84,124,40.4
75622265791,"Mézières (VD)",809,494,61.1,487,203,284,41.7
75622265792,"Montpreveyres",311,169,54.3,167,61,106,36.5
75622225798,"Ropraz",267,161,60.3,160,79,81,49.4
75622265799,"Servion",1233,751,60.9,732,303,429,41.4
75622225803,"Vulliens",308,202,65.6,199,110,89,55.3
75622235804,"Jorat-Menthue",951,594,62.5,589,275,314,46.7
75622265805,"Oron",3185,1798,56.5,1774,779,995,43.9
75622225812,"Champtauroz",85,57,67.1,56,23,33,41.1
75622225813,"Chevroux",291,187,64.3,184,98,86,53.3
75622225816,"Corcelles-près-Payerne",1246,793,63.6,782,438,344,56
75622225817,"Grandcour",583,360,61.7,356,175,181,49.2
75622225819,"Henniez",174,83,47.7,83,47,36,56.6
75622225821,"Missy",230,153,66.5,152,64,88,42.1
75622225822,"Payerne",4724,2518,53.3,2483,1361,1122,54.8
75622225827,"Trey",178,118,66.3,118,57,61,48.3
75622225828,"Treytorrens (Payerne)",96,57,59.4,56,29,27,51.8
75622225830,"Villarzel",297,173,58.2,172,96,76,55.8
75622225831,"Valbroye",1840,1034,56.2,1020,529,491,51.9
75622305841,"Château-d'Oex",2062,1075,52.1,1062,455,607,42.8
75622305842,"Rossinière",366,180,49.2,179,85,94,47.5
75622305843,"Rougemont",495,276,55.8,274,158,116,57.7
75622275851,"Allaman",244,159,65.2,157,57,100,36.3
75622285852,"Bursinel",250,141,56.4,140,50,90,35.7
75622285853,"Bursins",467,323,69.2,320,114,206,35.6
75622285854,"Burtigny",214,148,69.2,142,63,79,44.4
75622285855,"Dully",262,165,63,164,55,109,33.5
75622285856,"Essertines-sur-Rolle",367,244,66.5,238,90,148,37.8
75622285857,"Gilly",585,388,66.3,379,171,208,45.1
75622285858,"Luins",295,177,60,174,75,99,43.1
75622285859,"Mont-sur-Rolle",1361,815,59.9,805,320,485,39.8
75622285860,"Perroy",758,475,62.7,469,179,290,38.2
75622285861,"Rolle",2551,1443,56.6,1413,516,897,36.5
75622285862,"Tartegnin",134,103,76.9,102,32,70,31.4
75622285863,"Vinzel",205,133,64.9,125,34,91,27.2
75622245871,"L'Abbaye",967,559,57.8,546,223,323,40.8
75622245872,"Le Chenit",2675,1478,55.3,1453,641,812,44.1
75622245873,"Le Lieu",598,354,59.2,346,138,208,39.9
75622305881,"Blonay",3645,2337,64.1,2295,787,1508,34.3
75622305882,"Chardonne",1746,1156,66.2,1142,402,740,35.2
75622305883,"Corseaux",1366,927,67.9,910,305,605,33.5
75622305884,"Corsier-sur-Vevey",1846,1099,59.5,1073,469,604,43.7
75622305885,"Jongny",877,602,68.6,592,232,360,39.2
75622305886,"Montreux",11585,6198,53.5,6106,2485,3621,40.7
75622305888,"Saint-Légier-La Chiésaz",2981,2013,67.5,1973,674,1299,34.2
75622305889,"La Tour-de-Peilz",6456,3982,61.7,3928,1416,2512,36
75622305890,"Vevey",8682,4612,53.1,4557,1603,2954,35.2
75622305891,"Veytaux",507,269,53.1,262,102,160,38.9
75622245902,"Belmont-sur-Yverdon",248,129,52,127,62,65,48.8
75622245903,"Bioley-Magnoux",151,106,70.2,106,62,44,58.5
75622245904,"Chamblon",409,244,59.7,236,109,127,46.2
75622245905,"Champvent",366,226,61.7,221,107,114,48.4
75622245907,"Chavannes-le-Chêne",197,91,46.2,91,42,49,46.2
75622245908,"Chêne-Pâquier",94,66,70.2,65,32,33,49.2
75622245909,"Cheseaux-Noréaz",449,302,67.3,295,102,193,34.6
75622245910,"Cronay",267,169,63.3,168,70,98,41.7
75622245911,"Cuarny",150,90,60,90,58,32,64.4
75622245912,"Démoret",100,77,77,74,35,39,47.3
75622245913,"Donneloye",542,315,58.1,313,157,156,50.2
75622245914,"Ependes (VD)",229,139,60.7,139,69,70,49.6
75622245915,"Essert-Pittet",88,50,56.8,50,22,28,44
75622245919,"Mathod",367,250,68.1,245,109,136,44.5
75622245921,"Molondin",151,109,72.2,109,57,52,52.3
75622245922,"Montagny-près-Yverdon",475,272,57.3,266,108,158,40.6
75622235923,"Oppens",114,85,74.6,85,41,44,48.2
75622245924,"Orges",196,116,59.2,114,45,69,39.5
75622245925,"Orzens",155,102,65.8,101,44,57,43.6
75622245926,"Pomy",473,311,65.8,305,126,179,41.3
75622245928,"Rovray",116,90,77.6,89,52,37,58.4
75622245929,"Suchy",312,211,67.6,206,78,128,37.9
75622245930,"Suscévaz",148,99,66.9,99,51,48,51.5
75622245931,"Treycovagnes",335,220,65.7,217,89,128,41
75622245932,"Ursins",155,95,61.3,93,39,54,41.9
75622245933,"Valeyres-sous-Montagny",453,257,56.7,252,99,153,39.3
75622245934,"Valeyres-sous-Ursins",173,129,74.6,124,64,60,51.6
75622245935,"Villars-Epeney",65,46,70.8,46,23,23,50
75622245937,"Vugelles-La Mothe",79,46,58.2,46,27,19,58.7
75622245938,"Yverdon-les-Bains",14939,7977,53.4,7848,3260,4588,41.5
75622245939,"Yvonand",1966,1139,57.9,1128,508,620,45
75623016002,"Brig-Glis",9106,5231,57.4,5096,2689,2407,52.8
75623016004,"Eggerberg",277,162,58.5,161,107,54,66.5
75623016007,"Naters",6979,4194,60.1,4139,2297,1842,55.5
75623016008,"Ried-Brig",1463,896,61.2,881,463,418,52.6
75623016009,"Simplon",281,162,57.7,157,84,73,53.5
75623016010,"Termen",652,412,63.2,408,211,197,51.7
75623016011,"Zwischbergen",61,41,67.2,41,32,9,78
75623026021,"Ardon",1514,955,63.1,921,474,447,51.5
75623026022,"Chamoson",2215,1494,67.4,1460,689,771,47.2
75623026023,"Conthey",5065,3090,61,3028,1466,1562,48.4
75623026024,"Nendaz",4345,2574,59.2,2522,1145,1377,45.4
75623026025,"Vétroz",3165,2058,65,2006,1001,1005,49.9
75623036031,"Bagnes",4445,2566,57.7,2508,1058,1450,42.2
75623036032,"Bourg-Saint-Pierre",137,109,79.6,108,48,60,44.4
75623036033,"Liddes",541,355,65.6,349,147,202,42.1
75623036034,"Orsières",2127,1483,69.7,1454,637,817,43.8
75623036035,"Sembrancher",628,402,64,393,229,164,58.3
75623036036,"Vollèges",1214,763,62.9,745,288,457,38.7
75623046052,"Bellwald",300,178,59.3,177,87,90,49.2
75623046054,"Binn",111,59,53.2,58,23,35,39.7
75623046055,"Blitzingen",57,30,52.6,30,16,14,53.3
75623046056,"Ernen",433,243,56.1,241,120,121,49.8
75623046057,"Fiesch",695,393,56.5,390,197,193,50.5
75623046058,"Fieschertal",245,151,61.6,149,85,64,57
75623046061,"Lax",192,125,65.1,124,52,72,41.9
75623046064,"Niederwald",35,27,77.1,27,8,19,29.6
75623046073,"Grafschaft",149,107,71.8,107,70,37,65.4
75623046074,"Münster-Geschinen",369,200,54.2,198,91,107,46
75623046075,"Reckingen-Gluringen",363,202,55.6,193,102,91,52.8
75623046076,"Obergoms",497,267,53.7,262,140,122,53.4
75623056081,"Les Agettes",232,152,65.5,151,74,77,49
75623056082,"Ayent",2767,1753,63.4,1715,703,1012,41
75623056083,"Evolène",1325,982,74.1,968,441,527,45.6
75623056084,"Hérémence",1126,823,73.1,807,412,395,51.1
75623056087,"Saint-Martin (VS)",704,531,75.4,524,227,297,43.3
75623056089,"Vex",1167,772,66.2,742,342,400,46.1
75623056090,"Mont-Noble",763,510,66.8,494,209,285,42.3
75623066101,"Agarn",588,382,65,370,213,157,57.6
75623066102,"Albinen",200,138,69,135,69,66,51.1
75623066104,"Ergisch",165,132,80,131,97,34,74
75623066109,"Inden",83,53,63.9,53,24,29,45.3
75623066110,"Leuk",2773,1774,64,1752,965,787,55.1
75623066111,"Leukerbad",799,420,52.6,409,203,206,49.6
75623066112,"Oberems",97,52,53.6,52,25,27,48.1
75623066113,"Salgesch",974,713,73.2,698,431,267,61.7
75623066116,"Varen",483,294,60.9,287,148,139,51.6
75623066117,"Guttet-Feschel",333,204,61.3,198,119,79,60.1
75623066118,"Gampel-Bratsch",1433,1020,71.2,1009,594,415,58.9
75623066119,"Turtmann-Unterems",863,564,65.4,546,320,226,58.6
75623076131,"Bovernier",599,398,66.4,392,192,200,49
75623076132,"Charrat",853,681,79.8,657,315,342,47.9
75623076133,"Fully",5101,3321,65.1,3234,1443,1791,44.6
75623076134,"Isérables",725,470,64.8,462,273,189,59.1
75623076135,"Leytron",2019,1397,69.2,1378,682,696,49.5
75623076136,"Martigny",9662,5922,61.3,5795,2448,3347,42.2
75623076137,"Martigny-Combe",1588,985,62,953,425,528,44.6
75623076139,"Riddes",1629,1078,66.2,1055,521,534,49.4
75623076140,"Saillon",1478,960,65,945,427,518,45.2
75623076141,"Saxon",2729,1884,69,1839,1061,778,57.7
75623076142,"Trient",111,82,73.9,82,39,43,47.6
75623086151,"Champéry",801,520,64.9,506,220,286,43.5
75623086152,"Collombey-Muraz",4637,2686,57.9,2638,1377,1261,52.2
75623086153,"Monthey",9624,5574,57.9,5413,2538,2875,46.9
75623086154,"Port-Valais",2109,1191,56.5,1169,643,526,55
75623086155,"Saint-Gingolph",613,358,58.4,348,170,178,48.9
75623086156,"Troistorrents",3021,1940,64.2,1883,1056,827,56.1
75623086157,"Val-d'Illiez",1219,797,65.4,778,472,306,60.7
75623086158,"Vionnaz",1526,920,60.3,893,423,470,47.4
75623086159,"Vouvry",2294,1246,54.3,1220,630,590,51.6
75623096172,"Bister",27,16,59.3,16,11,5,68.8
75623096173,"Bitsch",645,394,61.1,391,225,166,57.5
75623096177,"Grengiols",358,172,48,164,95,69,57.9
75623096181,"Riederalp",348,205,58.9,201,94,107,46.8
75623096191,"Ausserberg",495,367,74.1,366,221,145,60.4
75623096192,"Blatten",230,158,68.7,154,89,65,57.8
75623096193,"Bürchen",580,357,61.6,353,176,177,49.9
75623096194,"Eischoll",385,203,52.7,203,116,87,57.1
75623096195,"Ferden",215,124,57.7,123,64,59,52
75623096197,"Kippel",302,176,58.3,174,68,106,39.1
75623096198,"Niedergesteln",514,331,64.4,327,170,157,52
75623096199,"Raron",1301,782,60.1,767,429,338,55.9
75623096201,"Unterbäch",328,175,53.4,175,71,104,40.6
75623096202,"Wiler (Lötschen)",411,215,52.3,214,104,110,48.6
75623096203,"Mörel-Filet",505,329,65.1,323,157,166,48.6
75623096204,"Steg-Hohtenn",1180,779,66,768,430,338,56
75623096205,"Bettmeralp",335,162,48.4,158,87,71,55.1
75623106211,"Collonges",471,288,61.1,286,133,153,46.5
75623106212,"Dorénaz",541,341,63,337,191,146,56.7
75623106213,"Evionnaz",792,492,62.1,480,236,244,49.2
75623106214,"Finhaut",263,174,66.2,170,53,117,31.2
75623106215,"Massongex",1077,666,61.8,650,296,354,45.5
75623106217,"Saint-Maurice",2571,1628,63.3,1588,673,915,42.4
75623106218,"Salvan",952,592,62.2,587,226,361,38.5
75623106219,"Vernayaz",1082,697,64.4,681,309,372,45.4
75623106220,"Vérossaz",479,325,67.8,322,140,182,43.5
75623116232,"Chalais",2229,1424,63.9,1383,650,733,47
75623116234,"Chermignon",1837,1286,70,1278,623,655,48.7
75623116235,"Chippis",767,503,65.6,490,235,255,48
75623116238,"Grône",1504,930,61.8,916,470,446,51.3
75623116239,"Icogne",378,238,63,231,105,126,45.5
75623116240,"Lens",2305,1518,65.9,1495,746,749,49.9
75623116241,"Miège",882,598,67.8,582,240,342,41.2
75623116242,"Mollens (VS)",558,359,64.3,346,167,179,48.3
75623116243,"Montana",1438,903,62.8,889,438,451,49.3
75623116244,"Randogne",1530,938,61.3,921,436,485,47.3
75623116246,"Saint-Léonard",1448,1031,71.2,996,455,541,45.7
75623116248,"Sierre",9463,5876,62.1,5672,2658,3014,46.9
75623116249,"Venthône",876,615,70.2,606,246,360,40.6
75623116250,"Veyras",1194,814,68.2,796,362,434,45.5
75623116252,"Anniviers",1765,1168,66.2,1147,461,686,40.2
75623126261,"Arbaz",807,508,62.9,495,245,250,49.5
75623126263,"Grimisuat",2027,1421,70.1,1388,545,843,39.3
75623126265,"Savièse",4972,3410,68.6,3393,1673,1720,49.3
75623126266,"Sion",19836,12105,61,11792,4769,7023,40.4
75623126267,"Veysonnaz",404,207,51.2,204,63,141,30.9
75623136281,"Baltschieder",911,531,58.3,525,306,219,58.3
75623136282,"Eisten",176,94,53.4,94,48,46,51.1
75623136283,"Embd",257,133,51.8,133,88,45,66.2
75623136285,"Grächen",1034,539,52.1,529,318,211,60.1
75623136286,"Lalden",494,328,66.4,322,190,132,59
75623136287,"Randa",283,174,61.5,174,105,69,60.3
75623136288,"Saas-Almagell",279,183,65.6,183,113,70,61.7
75623136289,"Saas-Balen",298,202,67.8,200,134,66,67
75623136290,"Saas-Fee",982,571,58.1,562,214,348,38.1
75623136291,"Saas-Grund",783,443,56.6,441,311,130,70.5
75623136292,"St. Niklaus",1699,919,54.1,904,592,312,65.5
75623136293,"Stalden (VS)",866,566,65.4,560,334,226,59.6
75623136294,"Staldenried",453,293,64.7,291,143,148,49.1
75623136295,"Täsch",486,255,52.5,253,167,86,66
75623136296,"Törbel",392,228,58.2,227,162,65,71.4
75623136297,"Visp",4831,2758,57.1,2698,1439,1259,53.3
75623136298,"Visperterminen",1098,655,59.7,650,265,385,40.8
75623136299,"Zeneggen",205,114,55.6,114,53,61,46.5
75623136300,"Zermatt",2991,1534,51.3,1469,818,651,55.7
75623046391,"Kommunanz Reckingen-Gluringen/Grafschaft",NA,NA,NA,NA,NA,NA,NA
75624016402,"Bevaix",2577,1576,61.2,1554,612,942,39.4
75624016404,"Boudry",3203,1723,53.8,1696,704,992,41.5
75624016405,"Brot-Dessous",102,65,63.7,63,32,31,50.8
75624016407,"Corcelles-Cormondrèche",3020,1969,65.2,1950,576,1374,29.5
75624016408,"Cortaillod",3073,1770,57.6,1737,657,1080,37.8
75624016409,"Fresens",166,124,74.7,124,45,79,36.3
75624016410,"Gorgier",1394,833,59.8,819,324,495,39.6
75624016411,"Montalchez",171,101,59.1,98,48,50,49
75624016412,"Peseux",3221,1740,54,1716,734,982,42.8
75624016413,"Rochefort",832,525,63.1,517,193,324,37.3
75624016414,"Saint-Aubin-Sauges",1567,903,57.6,891,330,561,37
75624016415,"Vaumarcus",173,123,71.1,122,35,87,28.7
75624016416,"Milvignes",5969,3692,61.9,3643,1295,2348,35.5
75624026421,"La Chaux-de-Fonds",22670,11478,50.6,11281,4491,6790,39.8
75624026422,"Les Planchettes",163,97,59.5,96,43,53,44.8
75624026423,"La Sagne",801,449,56.1,439,212,227,48.3
75624036431,"Les Brenets",850,491,57.8,486,232,254,47.7
75624036432,"La Brévine",531,321,60.5,318,190,128,59.7
75624036433,"Brot-Plamboz",193,123,63.7,119,73,46,61.3
75624036434,"Le Cerneux-Péquignot",263,160,60.8,160,84,76,52.5
75624036435,"La Chaux-du-Milieu",352,234,66.5,232,100,132,43.1
75624036436,"Le Locle",6444,3365,52.2,3318,1509,1809,45.5
75624036437,"Les Ponts-de-Martel",985,592,60.1,579,280,299,48.4
75624046451,"Cornaux",989,588,59.5,584,296,288,50.7
75624046452,"Cressier (NE)",1143,683,59.8,676,283,393,41.9
75624046453,"Enges",205,125,61,123,48,75,39
75624046454,"Hauterive (NE)",1640,995,60.7,985,325,660,33
75624046455,"Le Landeron",2979,1633,54.8,1616,690,926,42.7
75624046456,"Lignières",653,368,56.4,365,161,204,44.1
75624046458,"Neuchâtel",19630,10677,54.4,10539,3290,7249,31.2
75624046459,"Saint-Blaise",2158,1329,61.6,1311,407,904,31
75624046461,"La Tène",2858,1661,58.1,1639,621,1018,37.9
75624056485,"Valangin",284,185,65.1,185,71,114,38.4
75624056487,"Val-de-Ruz",10823,6278,58,6176,2612,3564,42.3
75624066504,"La Côte-aux-Fées",380,258,67.9,257,127,130,49.4
75624066511,"Les Verrières",576,295,51.2,290,139,151,47.9
75624066512,"Val-de-Travers",7591,3743,49.3,3699,1866,1833,50.4
75625006601,"Aire-la-Ville",678,455,67.1,442,180,262,40.7
75625006602,"Anières",1239,845,68.2,835,303,532,36.3
75625006603,"Avully",1080,641,59.4,627,263,364,41.9
75625006604,"Avusy",946,626,66.2,613,227,386,37
75625006605,"Bardonnex",1359,943,69.4,895,310,585,34.6
75625006606,"Bellevue",1481,855,57.7,834,345,489,41.4
75625006607,"Bernex",6043,3787,62.7,3700,1425,2275,38.5
75625006608,"Carouge (GE)",10134,5962,58.8,5832,2182,3650,37.4
75625006609,"Cartigny",542,392,72.3,387,124,263,32
75625006610,"Céligny",347,222,64,217,68,149,31.3
75625006611,"Chancy",733,430,58.7,421,180,241,42.8
75625006612,"Chêne-Bougeries",5757,3651,63.4,3569,1249,2320,35
75625006613,"Chêne-Bourg",4092,2355,57.6,2310,891,1419,38.6
75625006614,"Choulex",630,423,67.1,414,155,259,37.4
75625006615,"Collex-Bossy",867,570,65.7,560,181,379,32.3
75625006616,"Collonge-Bellerive",4180,2787,66.7,2735,961,1774,35.1
75625006617,"Cologny",2519,1598,63.4,1571,595,976,37.9
75625006618,"Confignon",2730,1823,66.8,1769,588,1181,33.2
75625006619,"Corsier (GE)",1077,718,66.7,707,266,441,37.6
75625006620,"Dardagny",828,514,62.1,507,203,304,40
75625006621,"Genève",81774,46286,56.6,45332,17168,28164,37.9
75625006622,"Genthod",1352,839,62.1,827,332,495,40.1
75625006623,"Le Grand-Saconnex",4989,2748,55.1,2700,1118,1582,41.4
75625006624,"Gy",303,189,62.4,189,58,131,30.7
75625006625,"Hermance",519,340,65.5,332,106,226,31.9
75625006626,"Jussy",755,525,69.5,517,217,300,42
75625006627,"Laconnex",431,311,72.2,304,94,210,30.9
75625006628,"Lancy",14709,8371,56.9,8172,3609,4563,44.2
75625006629,"Meinier",1277,833,65.2,817,310,507,37.9
75625006630,"Meyrin",9660,5386,55.8,5283,2550,2733,48.3
75625006631,"Onex",9154,5169,56.5,5047,2411,2636,47.8
75625006632,"Perly-Certoux",1742,1032,59.2,1005,442,563,44
75625006633,"Plan-les-Ouates",5678,3536,62.3,3454,1362,2092,39.4
75625006634,"Pregny-Chambésy",1399,872,62.3,855,300,555,35.1
75625006635,"Presinge",391,245,62.7,238,79,159,33.2
75625006636,"Puplinge",1334,882,66.1,862,357,505,41.4
75625006637,"Russin",290,211,72.8,206,78,128,37.9
75625006638,"Satigny",2116,1391,65.7,1367,520,847,38
75625006639,"Soral",462,303,65.6,293,111,182,37.9
75625006640,"Thônex",7263,4277,58.9,4194,1856,2338,44.3
75625006641,"Troinex",1409,951,67.5,931,311,620,33.4
75625006642,"Vandoeuvres",1418,957,67.5,935,337,598,36
75625006643,"Vernier",14730,7810,53,7611,3739,3872,49.1
75625006644,"Versoix",5763,3338,57.9,3252,1324,1928,40.7
75625006645,"Veyrier",6173,3940,63.8,3865,1376,2489,35.6
75626016702,"Boécourt",640,325,50.8,320,151,169,47.2
75626016703,"Bourrignon",236,151,64,147,79,68,53.7
75626016704,"Châtillon (JU)",318,179,56.3,178,93,85,52.2
75626016705,"Corban",363,196,54,195,99,96,50.8
75626016706,"Courchapoix",312,163,52.2,159,72,87,45.3
75626016708,"Courrendlin",1719,807,46.9,796,425,371,53.4
75626016709,"Courroux",2199,1114,50.7,1098,572,526,52.1
75626016710,"Courtételle",1714,847,49.4,834,356,478,42.7
75626016711,"Delémont",7648,3803,49.7,3755,1214,2541,32.3
75626016712,"Develier",986,512,51.9,502,205,297,40.8
75626016713,"Ederswiler",102,50,49,50,46,4,92
75626016715,"Mervelier",434,230,53,222,92,130,41.4
75626016716,"Mettembert",80,55,68.8,55,12,43,21.8
75626016718,"Movelier",301,170,56.5,165,100,65,60.6
75626016719,"Pleigne",318,165,51.9,163,66,97,40.5
75626016720,"Rebeuvelier",291,158,54.3,154,84,70,54.5
75626016721,"Rossemaison",435,254,58.4,250,99,151,39.6
75626016722,"Saulcy",207,102,49.3,100,37,63,37
75626016724,"Soyhières",343,169,49.3,165,93,72,56.4
75626016728,"Vellerat",58,41,70.7,41,24,17,58.5
75626016729,"Haute-Sorne",4667,2336,50.1,2298,1077,1221,46.9
75626016730,"Val Terbi",1937,973,50.2,958,406,552,42.4
75626026741,"Le Bémont (JU)",265,128,48.3,125,60,65,48
75626026742,"Les Bois",851,406,47.7,400,141,259,35.3
75626026743,"Les Breuleux",1029,555,53.9,538,198,340,36.8
75626026744,"La Chaux-des-Breuleux",87,54,62.1,54,28,26,51.9
75626026745,"Les Enfers",116,68,58.6,66,29,37,43.9
75626026748,"Les Genevez (JU)",438,234,53.4,232,108,124,46.6
75626026750,"Lajoux (JU)",532,279,52.4,275,100,175,36.4
75626026751,"Montfaucon",466,244,52.4,242,90,152,37.2
75626026753,"Muriaux",434,230,53,225,104,121,46.2
75626026754,"Le Noirmont",1251,641,51.2,628,256,372,40.8
75626026757,"Saignelégier",1916,1012,52.8,995,337,658,33.9
75626026758,"Saint-Brais",201,110,54.7,110,55,55,50
75626026759,"Soubey",146,57,39,56,28,28,50
75626036771,"Alle",1201,675,56.2,665,335,330,50.4
75626036773,"Beurnevésin",116,69,59.5,67,42,25,62.7
75626036774,"Boncourt",1023,534,52.2,528,237,291,44.9
75626036775,"Bonfol",596,289,48.5,284,183,101,64.4
75626036778,"Bure",572,340,59.4,334,192,142,57.5
75626036781,"Coeuve",540,275,50.9,266,137,129,51.5
75626036782,"Cornol",752,362,48.1,359,190,169,52.9
75626036783,"Courchavon",221,141,63.8,140,66,74,47.1
75626036784,"Courgenay",1638,797,48.7,788,411,377,52.2
75626036785,"Courtedoux",609,319,52.4,314,158,156,50.3
75626036787,"Damphreux",137,82,59.9,82,51,31,62.2
75626036789,"Fahy",300,156,52,148,79,69,53.4
75626036790,"Fontenais",1249,709,56.8,695,288,407,41.4
75626036792,"Grandfontaine",290,159,54.8,157,50,107,31.8
75626036793,"Lugnez",146,72,49.3,70,47,23,67.1
75626036800,"Porrentruy",4724,2383,50.4,2342,907,1435,38.7
75626036803,"Rocourt",132,84,63.6,83,44,39,53
75626036806,"Vendlincourt",442,245,55.4,242,130,112,53.7
75626036807,"Basse-Allaine",983,456,46.4,449,222,227,49.4
75626036808,"Clos du Doubs",1061,526,49.6,523,278,245,53.2
75626036809,"Haute-Ajoie",830,439,52.9,434,224,210,51.6
75626036810,"La Baroche",886,468,52.8,458,239,219,52.2
75603009030,"LU-Ausland-CH",3839,1753,45.7,1711,551,1160,32.2
75604009040,"UR-Ausland-CH",413,166,40.2,166,57,109,34.3
75610009100,"FR-CH de l'étranger",4349,1765,40.6,1738,596,1142,34.3
75612009120,"BS-Ausland-CH",7043,2780,39.5,2760,784,1976,28.4
75616009160,"AI-Ausland-CH",301,108,35.9,104,51,53,49
75617009170,"SG-Ausland-CH",5793,2683,46.3,2657,1011,1646,38.1
75619009190,"AG-Ausland-CH",7510,2990,39.8,2960,1015,1945,34.3
75620009200,"TG-Ausland-CH",2808,1230,43.8,1217,453,764,37.2
75622009220,"VD-CH de l'étranger",15211,5615,36.9,5529,1706,3823,30.9
75623009230,"VS-CH de l'étranger",4536,1678,37,1603,543,1060,33.9
75625009250,"GE-CH de l'étranger",21299,9507,44.6,9366,2684,6682,28.7
