"id","municipality_name","valid_votes","yes","no","yes_percentage"
75601010001,"Aeugst am Albis",1008,365,643,36.2
75601010002,"Affoltern am Albis",4444,1692,2752,38.1
75601010003,"Bonstetten",2604,912,1692,35
75601010004,"Hausen am Albis",1703,618,1085,36.3
75601010005,"Hedingen",1834,596,1238,32.5
75601010006,"Kappel am Albis",464,220,244,47.4
75601010007,"Knonau",960,348,612,36.3
75601010008,"Maschwanden",325,142,183,43.7
75601010009,"Mettmenstetten",2323,880,1443,37.9
75601010010,"Obfelden",2183,921,1262,42.2
75601010011,"Ottenbach",1385,513,872,37
75601010012,"Rifferswil",560,181,379,32.3
75601010013,"Stallikon",1596,652,944,40.9
75601010014,"Wettswil am Albis",2475,858,1617,34.7
75601020021,"Adlikon",342,222,120,64.9
75601020022,"Benken (ZH)",411,218,193,53
75601020023,"Berg am Irchel",343,164,179,47.8
75601020024,"Buch am Irchel",543,276,267,50.8
75601020025,"Dachsen",868,303,565,34.9
75601020026,"Dorf",342,183,159,53.5
75601020027,"Feuerthalen",1519,569,950,37.5
75601020028,"Flaach",673,364,309,54.1
75601020029,"Flurlingen",704,236,468,33.5
75601020030,"Andelfingen",1107,426,681,38.5
75601020031,"Henggart",1161,495,666,42.6
75601020032,"Humlikon",266,136,130,51.1
75601020033,"Kleinandelfingen",1022,464,558,45.4
75601020034,"Laufen-Uhwiesen",792,375,417,47.3
75601020035,"Marthalen",990,521,469,52.6
75601020036,"Oberstammheim",636,271,365,42.6
75601020037,"Ossingen",687,314,373,45.7
75601020038,"Rheinau",628,221,407,35.2
75601020039,"Thalheim an der Thur",454,274,180,60.4
75601020040,"Trüllikon",509,276,233,54.2
75601020041,"Truttikon",273,153,120,56
75601020042,"Unterstammheim",497,207,290,41.6
75601020043,"Volken",154,86,68,55.8
75601020044,"Waltalingen",362,168,194,46.4
75601030051,"Bachenbülach",1429,610,819,42.7
75601030052,"Bassersdorf",4356,1783,2573,40.9
75601030053,"Bülach",7119,2874,4245,40.4
75601030054,"Dietlikon",3010,1150,1860,38.2
75601030055,"Eglisau",2156,843,1313,39.1
75601030056,"Embrach",3223,1559,1664,48.4
75601030057,"Freienstein-Teufen",1137,477,660,42
75601030058,"Glattfelden",1856,920,936,49.6
75601030059,"Hochfelden",886,443,443,50
75601030060,"Höri",853,486,367,57
75601030061,"Hüntwangen",513,234,279,45.6
75601030062,"Kloten",5696,2734,2962,48
75601030063,"Lufingen",888,440,448,49.5
75601030064,"Nürensdorf",2631,1302,1329,49.5
75601030065,"Oberembrach",564,313,251,55.5
75601030066,"Opfikon",4551,1934,2617,42.5
75601030067,"Rafz",1874,829,1045,44.2
75601030068,"Rorbas",885,401,484,45.3
75601030069,"Wallisellen",5582,2081,3501,37.3
75601030070,"Wasterkingen",306,161,145,52.6
75601030071,"Wil (ZH)",722,382,340,52.9
75601030072,"Winkel",2025,985,1040,48.6
75601040081,"Bachs",312,197,115,63.1
75601040082,"Boppelsen",685,288,397,42
75601040083,"Buchs (ZH)",2295,1101,1194,48
75601040084,"Dällikon",1365,687,678,50.3
75601040085,"Dänikon",724,341,383,47.1
75601040086,"Dielsdorf",2094,974,1120,46.5
75601040087,"Hüttikon",387,200,187,51.7
75601040088,"Neerach",1563,836,727,53.5
75601040089,"Niederglatt",1759,922,837,52.4
75601040090,"Niederhasli",3291,1597,1694,48.5
75601040091,"Niederweningen",1306,546,760,41.8
75601040092,"Oberglatt",1855,908,947,48.9
75601040093,"Oberweningen",806,375,431,46.5
75601040094,"Otelfingen",1161,487,674,41.9
75601040095,"Regensberg",228,83,145,36.4
75601040096,"Regensdorf",5560,2707,2853,48.7
75601040097,"Rümlang",2542,1323,1219,52
75601040098,"Schleinikon",374,175,199,46.8
75601040099,"Schöfflisdorf",685,330,355,48.2
75601040100,"Stadel",993,584,409,58.8
75601040101,"Steinmaur",1408,684,724,48.6
75601040102,"Weiach",559,348,211,62.3
75601050111,"Bäretswil",2435,1221,1214,50.1
75601050112,"Bubikon",3481,1555,1926,44.7
75601050113,"Dürnten",3177,1499,1678,47.2
75601050114,"Fischenthal",1027,627,400,61.1
75601050115,"Gossau (ZH)",4681,2188,2493,46.7
75601050116,"Grüningen",1626,741,885,45.6
75601050117,"Hinwil",5005,2480,2525,49.6
75601050118,"Rüti (ZH)",4778,2070,2708,43.3
75601050119,"Seegräben",710,267,443,37.6
75601050120,"Wald (ZH)",3530,1582,1948,44.8
75601050121,"Wetzikon (ZH)",9272,3840,5432,41.4
75601060131,"Adliswil",6507,2351,4156,36.1
75601060132,"Hirzel",1055,434,621,41.1
75601060133,"Horgen",7445,2658,4787,35.7
75601060134,"Hütten",438,240,198,54.8
75601060135,"Kilchberg (ZH)",3426,1020,2406,29.8
75601060136,"Langnau am Albis",3045,1099,1946,36.1
75601060137,"Oberrieden",2507,813,1694,32.4
75601060138,"Richterswil",5779,2186,3593,37.8
75601060139,"Rüschlikon",2387,744,1643,31.2
75601060140,"Schönenberg (ZH)",985,509,476,51.7
75601060141,"Thalwil",7588,2296,5292,30.3
75601060142,"Wädenswil",9245,3309,5936,35.8
75601070151,"Erlenbach (ZH)",2586,775,1811,30
75601070152,"Herrliberg",3053,1105,1948,36.2
75601070153,"Hombrechtikon",3722,1619,2103,43.5
75601070154,"Küsnacht (ZH)",6393,2117,4276,33.1
75601070155,"Männedorf",5036,1560,3476,31
75601070156,"Meilen",6336,2041,4295,32.2
75601070157,"Oetwil am See",1578,756,822,47.9
75601070158,"Stäfa",6965,2225,4740,31.9
75601070159,"Uetikon am See",2892,1002,1890,34.6
75601070160,"Zumikon",2529,801,1728,31.7
75601070161,"Zollikon",5895,1618,4277,27.4
75601080172,"Fehraltorf",2816,1204,1612,42.8
75601080173,"Hittnau",1838,885,953,48.2
75601080176,"Lindau",2280,1037,1243,45.5
75601080177,"Pfäffikon",5133,1991,3142,38.8
75601080178,"Russikon",2084,965,1119,46.3
75601080180,"Weisslingen",1697,800,897,47.1
75601080181,"Wila",958,549,409,57.3
75601080182,"Wildberg",539,277,262,51.4
75601090191,"Dübendorf",8898,3716,5182,41.8
75601090192,"Egg",3903,1501,2402,38.5
75601090193,"Fällanden",3332,1171,2161,35.1
75601090194,"Greifensee",2421,761,1660,31.4
75601090195,"Maur",4666,1735,2931,37.2
75601090196,"Mönchaltorf",1730,685,1045,39.6
75601090197,"Schwerzenbach",1976,743,1233,37.6
75601090198,"Uster",14425,4784,9641,33.2
75601090199,"Volketswil",6880,3125,3755,45.4
75601090200,"Wangen-Brüttisellen",2838,1253,1585,44.2
75601100211,"Altikon",340,181,159,53.2
75601100213,"Brütten",1172,466,706,39.8
75601100214,"Dägerlen",527,245,282,46.5
75601100215,"Dättlikon",424,167,257,39.4
75601100216,"Dinhard",795,392,403,49.3
75601100217,"Elgg",1938,789,1149,40.7
75601100218,"Ellikon an der Thur",416,228,188,54.8
75601100219,"Elsau",1684,723,961,42.9
75601100220,"Hagenbuch",516,325,191,63
75601100221,"Hettlingen",1694,667,1027,39.4
75601100222,"Hofstetten (ZH)",250,157,93,62.8
75601100223,"Neftenbach",2683,1111,1572,41.4
75601100224,"Pfungen",1347,559,788,41.5
75601100225,"Rickenbach (ZH)",1256,578,678,46
75601100226,"Schlatt (ZH)",391,195,196,49.9
75601100227,"Seuzach",3659,1599,2060,43.7
75601100228,"Turbenthal",1800,898,902,49.9
75601100230,"Winterthur",44884,12745,32139,28.4
75601100231,"Zell (ZH)",2288,1046,1242,45.7
75601110241,"Aesch (ZH)",617,246,371,39.9
75601110242,"Birmensdorf (ZH)",2759,1035,1724,37.5
75601110243,"Dietikon",7064,2885,4179,40.8
75601110244,"Geroldswil",1826,832,994,45.6
75601110245,"Oberengstringen",2281,892,1389,39.1
75601110246,"Oetwil an der Limmat",1190,567,623,47.6
75601110247,"Schlieren",4351,1570,2781,36.1
75601110248,"Uitikon",2203,742,1461,33.7
75601110249,"Unterengstringen",1573,677,896,43
75601110250,"Urdorf",3977,1595,2382,40.1
75601110251,"Weiningen (ZH)",1711,802,909,46.9
75601120261,"Zürich",158549,35797,122752,22.6
75601080296,"Illnau-Effretikon",6588,2741,3847,41.6
75601080297,"Bauma",2200,1192,1008,54.2
75601100298,"Wiesendangen",3352,1468,1884,43.8
75602430301,"Aarberg",1923,885,1038,46
75602430302,"Bargen (BE)",472,204,268,43.2
75602430303,"Grossaffoltern",1499,660,839,44
75602430304,"Kallnach",881,447,434,50.7
75602430305,"Kappelen",621,323,298,52
75602430306,"Lyss",5746,2259,3487,39.3
75602460307,"Meikirch",1370,453,917,33.1
75602430309,"Radelfingen",635,292,343,46
75602430310,"Rapperswil (BE)",1231,598,633,48.6
75602430311,"Schüpfen",1732,690,1042,39.8
75602430312,"Seedorf (BE)",1499,764,735,51
75602440321,"Aarwangen",1825,876,949,48
75602440322,"Auswil",233,153,80,65.7
75602440323,"Bannwil",326,188,138,57.7
75602440324,"Bleienbach",343,196,147,57.1
75602440325,"Busswil bei Melchnau",106,65,41,61.3
75602440326,"Gondiswil",324,195,129,60.2
75602440329,"Langenthal",6052,2187,3865,36.1
75602440331,"Lotzwil",1000,421,579,42.1
75602440332,"Madiswil",1524,752,772,49.3
75602440333,"Melchnau",621,326,295,52.5
75602440334,"Obersteckholz",205,118,87,57.6
75602440335,"Oeschenbach",107,66,41,61.7
75602440336,"Reisiswil",88,55,33,62.5
75602440337,"Roggwil (BE)",1590,760,830,47.8
75602440338,"Rohrbach",609,353,256,58
75602440339,"Rohrbachgraben",181,117,64,64.6
75602440340,"Rütschelen",264,142,122,53.8
75602440341,"Schwarzhäusern",252,147,105,58.3
75602440342,"Thunstetten",1268,694,574,54.7
75602440344,"Ursenbach",337,188,149,55.8
75602440345,"Wynau",570,305,265,53.5
75602460351,"Bern",58795,10193,48602,17.3
75602460352,"Bolligen",3523,1073,2450,30.5
75602460353,"Bremgarten bei Bern",2433,602,1831,24.7
75602460354,"Kirchlindach",1692,548,1144,32.4
75602460355,"Köniz",18458,5253,13205,28.5
75602460356,"Muri bei Bern",6733,1855,4878,27.6
75602460357,"Oberbalm",421,249,172,59.1
75602460358,"Stettlen",1541,536,1005,34.8
75602460359,"Vechigen",2789,1099,1690,39.4
75602460360,"Wohlen bei Bern",5044,1535,3509,30.4
75602460361,"Zollikofen",4469,1532,2937,34.3
75602460362,"Ittigen",4625,1547,3078,33.4
75602460363,"Ostermundigen",5880,2005,3875,34.1
75602420371,"Biel/Bienne",16679,5204,11475,31.2
75602420372,"Evilard",1225,341,884,27.8
75602430381,"Arch",669,388,281,58
75602430382,"Büetigen",418,234,184,56
75602430383,"Büren an der Aare",1454,639,815,43.9
75602430385,"Diessbach bei Büren",433,224,209,51.7
75602430386,"Dotzigen",659,328,331,49.8
75602420387,"Lengnau (BE)",1753,835,918,47.6
75602430388,"Leuzigen",557,286,271,51.3
75602430389,"Meienried",NA,NA,NA,NA
75602420390,"Meinisberg",544,268,276,49.3
75602430391,"Oberwil bei Büren",380,200,180,52.6
75602420392,"Pieterlen",1242,627,615,50.5
75602430393,"Rüti bei Büren",372,195,177,52.4
75602430394,"Wengi",277,153,124,55.2
75602450401,"Aefligen",477,265,212,55.6
75602450402,"Alchenstorf",266,146,120,54.9
75602460403,"Bäriswil",573,272,301,47.5
75602450404,"Burgdorf",7032,2055,4977,29.2
75602450405,"Ersigen",1016,490,526,48.2
75602450406,"Hasle bei Burgdorf",1488,741,747,49.8
75602450407,"Heimiswil",666,359,307,53.9
75602450408,"Hellsau",NA,NA,NA,NA
75602450409,"Hindelbank",1030,459,571,44.6
75602450410,"Höchstetten",214,126,88,58.9
75602450411,"Kernenried",244,139,105,57
75602450412,"Kirchberg (BE)",2535,1046,1489,41.3
75602450413,"Koppigen",957,440,517,46
75602450414,"Krauchthal",1107,600,507,54.2
75602450415,"Lyssach",670,343,327,51.2
75602450416,"Mötschwil",139,67,72,48.2
75602450418,"Oberburg",1125,569,556,50.6
75602450420,"Rüdtligen-Alchenflüh",794,385,409,48.5
75602450421,"Rumendingen",46,23,23,50
75602450422,"Rüti bei Lyssach",NA,NA,NA,NA
75602450423,"Willadingen",108,53,55,49.1
75602450424,"Wynigen",993,505,488,50.9
75602410431,"Corgémont",606,299,307,49.3
75602410432,"Cormoret",218,73,145,33.5
75602410433,"Cortébert",243,112,131,46.1
75602410434,"Courtelary",502,225,277,44.8
75602410435,"La Ferrière",184,64,120,34.8
75602410437,"Mont-Tramelan",62,24,38,38.7
75602410438,"Orvin",485,212,273,43.7
75602410441,"Renan (BE)",356,154,202,43.3
75602410442,"Romont (BE)",99,53,46,53.5
75602410443,"Saint-Imier",1411,548,863,38.8
75602410444,"Sonceboz-Sombeval",620,288,332,46.5
75602410445,"Sonvilier",413,190,223,46
75602410446,"Tramelan",1733,692,1041,39.9
75602410448,"Villeret",355,149,206,42
75602410449,"Sauge",338,153,185,45.3
75602410450,"Péry-La Heutte",684,320,364,46.8
75602430491,"Brüttelen",248,146,102,58.9
75602430492,"Erlach",638,223,415,35
75602430493,"Finsterhennen",197,109,88,55.3
75602430494,"Gals",316,133,183,42.1
75602430495,"Gampelen",352,174,178,49.4
75602430496,"Ins",1487,600,887,40.3
75602430497,"Lüscherz",247,137,110,55.5
75602430498,"Müntschemier",497,271,226,54.5
75602430499,"Siselen",275,132,143,48
75602430500,"Treiten",200,120,80,60
75602430501,"Tschugg",199,66,133,33.2
75602430502,"Vinelz",449,175,274,39
75602450533,"Bätterkinden",1472,533,939,36.2
75602460535,"Deisswil bei Münchenbuchsee",NA,NA,NA,NA
75602460536,"Diemerswil",110,49,61,44.5
75602460538,"Fraubrunnen",2421,959,1462,39.6
75602460540,"Jegenstorf",2824,998,1826,35.3
75602460541,"Iffwil",208,100,108,48.1
75602460543,"Mattstetten",330,148,182,44.8
75602460544,"Moosseedorf",1614,673,941,41.7
75602460546,"Münchenbuchsee",4218,1446,2772,34.3
75602460551,"Urtenen-Schönbühl",2475,1029,1446,41.6
75602450552,"Utzenstorf",1893,840,1053,44.4
75602460553,"Wiggiswil",104,52,52,50
75602450554,"Wiler bei Utzenstorf",365,170,195,46.6
75602450556,"Zielebach",147,84,63,57.1
75602460557,"Zuzwil (BE)",315,120,195,38.1
75602490561,"Adelboden",1840,1169,671,63.5
75602490562,"Aeschi bei Spiez",1082,584,498,54
75602490563,"Frutigen",3276,1927,1349,58.8
75602490564,"Kandergrund",356,246,110,69.1
75602490565,"Kandersteg",548,260,288,47.4
75602490566,"Krattigen",535,219,316,40.9
75602490567,"Reichenbach im Kandertal",1611,1073,538,66.6
75602500571,"Beatenberg",548,301,247,54.9
75602500572,"Bönigen",1077,533,544,49.5
75602500573,"Brienz (BE)",1415,751,664,53.1
75602500574,"Brienzwiler",229,138,91,60.3
75602500575,"Därligen",178,92,86,51.7
75602500576,"Grindelwald",1526,966,560,63.3
75602500577,"Gsteigwiler",199,91,108,45.7
75602500578,"Gündlischwand",128,84,44,65.6
75602500579,"Habkern",284,200,84,70.4
75602500580,"Hofstetten bei Brienz",249,127,122,51
75602500581,"Interlaken",2039,823,1216,40.4
75602500582,"Iseltwald",194,118,76,60.8
75602500584,"Lauterbrunnen",901,430,471,47.7
75602500585,"Leissigen",436,230,206,52.8
75602500586,"Lütschental",98,69,29,70.4
75602500587,"Matten bei Interlaken",1606,714,892,44.5
75602500588,"Niederried bei Interlaken",155,79,76,51
75602500589,"Oberried am Brienzersee",190,98,92,51.6
75602500590,"Ringgenberg (BE)",1115,566,549,50.8
75602500591,"Saxeten",43,30,13,69.8
75602500592,"Schwanden bei Brienz",298,134,164,45
75602500593,"Unterseen",2508,1069,1439,42.6
75602500594,"Wilderswil",1054,541,513,51.3
75602460602,"Arni (BE)",426,261,165,61.3
75602460603,"Biglen",810,350,460,43.2
75602460605,"Bowil",613,360,253,58.7
75602460606,"Brenzikofen",265,160,105,60.4
75602460607,"Freimettigen",214,104,110,48.6
75602460608,"Grosshöchstetten",1716,661,1055,38.5
75602460609,"Häutligen",131,86,45,65.6
75602460610,"Herbligen",283,163,120,57.6
75602460611,"Kiesen",435,211,224,48.5
75602460612,"Konolfingen",2534,1114,1420,44
75602460613,"Landiswil",327,213,114,65.1
75602460614,"Linden",569,396,173,69.6
75602460615,"Mirchel",266,156,110,58.6
75602460616,"Münsingen",5939,2004,3935,33.7
75602460617,"Niederhünigen",321,139,182,43.3
75602460619,"Oberdiessbach",1702,855,847,50.2
75602460620,"Oberthal",330,198,132,60
75602460622,"Oppligen",287,149,138,51.9
75602460623,"Rubigen",1475,520,955,35.3
75602460624,"Schlosswil",315,145,170,46
75602460625,"Tägertschi",210,102,108,48.6
75602460626,"Walkringen",838,465,373,55.5
75602460627,"Worb",5191,1888,3303,36.4
75602460628,"Zäziwil",742,349,393,47
75602460629,"Oberhünigen",140,88,52,62.9
75602460630,"Allmendingen",288,141,147,49
75602460632,"Wichtrach",1942,852,1090,43.9
75602460661,"Clavaleyres",NA,NA,NA,NA
75602460662,"Ferenbalm",628,348,280,55.4
75602460663,"Frauenkappelen",605,223,382,36.9
75602460664,"Golaten",156,97,59,62.2
75602460665,"Gurbrü",125,66,59,52.8
75602460666,"Kriechenwil",208,102,106,49
75602460667,"Laupen",1367,478,889,35
75602460668,"Mühleberg",1392,645,747,46.3
75602460669,"Münchenwiler",217,108,109,49.8
75602460670,"Neuenegg",2324,1135,1189,48.8
75602460671,"Wileroltigen",171,102,69,59.6
75602410681,"Belprahon",167,84,83,50.3
75602410683,"Champoz",93,60,33,64.5
75602410687,"Corcelles (BE)",100,64,36,64
75602410690,"Court",570,322,248,56.5
75602410691,"Crémines",220,110,110,50
75602410692,"Eschert",135,70,65,51.9
75602410694,"Grandval",152,87,65,57.2
75602410696,"Loveresse",139,76,63,54.7
75602410700,"Moutier",2551,1021,1530,40
75602410701,"Perrefitte",181,97,84,53.6
75602410703,"Reconvilier",837,430,407,51.4
75602410704,"Roches (BE)",69,47,22,68.1
75602410706,"Saicourt",265,146,119,55.1
75602410707,"Saules (BE)",78,54,24,69.2
75602410708,"Schelten",21,12,9,57.1
75602410709,"Seehof",27,18,9,66.7
75602410711,"Sorvilier",121,55,66,45.5
75602410713,"Tavannes",1080,476,604,44.1
75602410715,"Rebévelier",20,11,9,55
75602410716,"Petit-Val",209,113,96,54.1
75602410717,"Valbirse",1485,743,742,50
75602410723,"La Neuveville",1490,442,1048,29.7
75602410724,"Nods",278,138,140,49.6
75602410726,"Plateau de Diesse",847,331,516,39.1
75602420731,"Aegerten",743,369,374,49.7
75602420732,"Bellmund",779,298,481,38.3
75602420733,"Brügg",1465,614,851,41.9
75602430734,"Bühl",220,124,96,56.4
75602430735,"Epsach",150,82,68,54.7
75602430736,"Hagneck",215,104,111,48.4
75602430737,"Hermrigen",149,91,58,61.1
75602430738,"Jens",370,165,205,44.6
75602420739,"Ipsach",1970,756,1214,38.4
75602420740,"Ligerz",307,90,217,29.3
75602430741,"Merzligen",219,86,133,39.3
75602420742,"Mörigen",468,232,236,49.6
75602420743,"Nidau",2481,813,1668,32.8
75602420744,"Orpund",1053,516,537,49
75602420745,"Port",1543,665,878,43.1
75602420746,"Safnern",905,456,449,50.4
75602420747,"Scheuren",245,123,122,50.2
75602420748,"Schwadernau",294,156,138,53.1
75602430749,"Studen (BE)",1172,558,614,47.6
75602420750,"Sutz-Lattrigen",667,272,395,40.8
75602430751,"Täuffelen",1348,619,729,45.9
75602430754,"Walperswil",461,242,219,52.5
75602430755,"Worben",1027,522,505,50.8
75602420756,"Twann-Tüscherz",607,219,388,36.1
75602490761,"Därstetten",398,272,126,68.3
75602490762,"Diemtigen",982,719,263,73.2
75602490763,"Erlenbach im Simmental",781,481,300,61.6
75602490766,"Oberwil im Simmental",416,290,126,69.7
75602470767,"Reutigen",502,289,213,57.6
75602490768,"Spiez",6058,2579,3479,42.6
75602490769,"Wimmis",1110,665,445,59.9
75602470770,"Stocken-Höfen",426,289,137,67.8
75602500782,"Guttannen",130,63,67,48.5
75602500783,"Hasliberg",465,260,205,55.9
75602500784,"Innertkirchen",456,271,185,59.4
75602500785,"Meiringen",1925,879,1046,45.7
75602500786,"Schattenhalb",236,140,96,59.3
75602480791,"Boltigen",610,414,196,67.9
75602480792,"Lenk",1095,660,435,60.3
75602480793,"St. Stephan",723,535,188,74
75602480794,"Zweisimmen",1372,708,664,51.6
75602480841,"Gsteig",370,206,164,55.7
75602480842,"Lauenen",341,200,141,58.7
75602480843,"Saanen",2525,1227,1298,48.6
75602460852,"Guggisberg",604,368,236,60.9
75602460853,"Rüschegg",708,405,303,57.2
75602460855,"Schwarzenburg",3152,1470,1682,46.6
75602460861,"Belp",5340,2341,2999,43.8
75602470863,"Burgistein",536,299,237,55.8
75602460865,"Gelterfingen",144,93,51,64.6
75602460866,"Gerzensee",588,264,324,44.9
75602470867,"Gurzelen",401,230,171,57.4
75602460868,"Jaberg",NA,NA,NA,NA
75602460869,"Kaufdorf",544,209,335,38.4
75602460870,"Kehrsatz",1802,592,1210,32.9
75602460872,"Kirchdorf (BE)",776,383,393,49.4
75602460873,"Kirchenthurnen",135,75,60,55.6
75602460874,"Lohnstorf",112,53,59,47.3
75602460875,"Mühledorf (BE)",126,53,73,42.1
75602460876,"Mühlethurnen",742,272,470,36.7
75602460877,"Niedermuhlern",NA,NA,NA,NA
75602460878,"Noflen",NA,NA,NA,NA
75602460879,"Riggisberg",1089,610,479,56
75602460880,"Rüeggisberg",836,492,344,58.9
75602460881,"Rümligen",231,118,113,51.1
75602470883,"Seftigen",1004,498,506,49.6
75602460884,"Toffen",1250,527,723,42.2
75602470885,"Uttigen",882,419,463,47.5
75602470886,"Wattenwil",1360,751,609,55.2
75602460888,"Wald (BE)",825,370,455,44.8
75602450901,"Eggiwil",940,674,266,71.7
75602450902,"Langnau im Emmental",4061,1674,2387,41.2
75602450903,"Lauperswil",1159,716,443,61.8
75602450904,"Röthenbach im Emmental",528,396,132,75
75602450905,"Rüderswil",1045,619,426,59.2
75602450906,"Schangnau",442,347,95,78.5
75602450907,"Signau",1237,728,509,58.9
75602450908,"Trub",580,389,191,67.1
75602450909,"Trubschachen",613,313,300,51.1
75602470921,"Amsoldingen",404,218,186,54
75602470922,"Blumenstein",593,350,243,59
75602470923,"Buchholterberg",743,517,226,69.6
75602470924,"Eriz",247,198,49,80.2
75602470925,"Fahrni",369,230,139,62.3
75602470927,"Heiligenschwendi",300,164,136,54.7
75602470928,"Heimberg",2936,1505,1431,51.3
75602470929,"Hilterfingen",2047,739,1308,36.1
75602470931,"Homberg",249,175,74,70.3
75602470932,"Horrenbach-Buchen",112,101,11,90.2
75602470934,"Oberhofen am Thunersee",1330,525,805,39.5
75602470935,"Oberlangenegg",226,171,55,75.7
75602470936,"Pohlern",115,78,37,67.8
75602470937,"Schwendibach",129,77,52,59.7
75602470938,"Sigriswil",2556,1559,997,61
75602470939,"Steffisburg",7422,3305,4117,44.5
75602470940,"Teuffenthal (BE)",87,64,23,73.6
75602470941,"Thierachern",1183,651,532,55
75602470942,"Thun",19403,7850,11553,40.5
75602470943,"Uebeschi",311,209,102,67.2
75602470944,"Uetendorf",2838,1575,1263,55.5
75602470945,"Unterlangenegg",433,295,138,68.1
75602470946,"Wachseldorn",122,93,29,76.2
75602470947,"Zwieselberg",151,82,69,54.3
75602470948,"Forst-Längenbühl",388,239,149,61.6
75602450951,"Affoltern im Emmental",514,294,220,57.2
75602450952,"Dürrenroth",464,274,190,59.1
75602440953,"Eriswil",564,323,241,57.3
75602440954,"Huttwil",1982,958,1024,48.3
75602450955,"Lützelflüh",1825,985,840,54
75602450956,"Rüegsau",1512,785,727,51.9
75602450957,"Sumiswald",2161,1070,1091,49.5
75602450958,"Trachselwald",433,263,170,60.7
75602440959,"Walterswil (BE)",235,150,85,63.8
75602440960,"Wyssachen",552,342,210,62
75602440971,"Attiswil",666,360,306,54.1
75602440972,"Berken",28,20,8,71.4
75602440973,"Bettenhausen",379,216,163,57
75602440975,"Farnern",95,55,40,57.9
75602440976,"Graben",158,93,65,58.9
75602440977,"Heimenhausen",506,278,228,54.9
75602440979,"Herzogenbuchsee",2931,1082,1849,36.9
75602440980,"Inkwil",357,204,153,57.1
75602440981,"Niederbipp",1607,899,708,55.9
75602440982,"Niederönz",782,345,437,44.1
75602440983,"Oberbipp",704,398,306,56.5
75602440985,"Ochlenberg",313,151,162,48.2
75602440987,"Rumisberg",257,159,98,61.9
75602440988,"Seeberg",737,373,364,50.6
75602440989,"Thörigen",488,280,208,57.4
75602440990,"Walliswil bei Niederbipp",105,57,48,54.3
75602440991,"Walliswil bei Wangen",274,152,122,55.5
75602440992,"Wangen an der Aare",963,464,499,48.2
75602440993,"Wangenried",205,105,100,51.2
75602440995,"Wiedlisbach",903,466,437,51.6
75602440996,"Wolfisberg",91,52,39,57.1
75603161001,"Doppleschwand",355,243,112,68.5
75603161002,"Entlebuch",1642,1035,607,63
75603161004,"Flühli",922,563,359,61.1
75603161005,"Hasle (LU)",880,621,259,70.6
75603161007,"Romoos",369,234,135,63.4
75603161008,"Schüpfheim",2160,1173,987,54.3
75603161009,"Werthenstein",979,660,319,67.4
75603161010,"Escholzmatt-Marbach",2173,1366,807,62.9
75603131021,"Aesch (LU)",550,309,241,56.2
75603131022,"Altwis",197,97,100,49.2
75603131023,"Ballwil",1379,768,611,55.7
75603131024,"Emmen",9912,4763,5149,48.1
75603131025,"Ermensee",460,221,239,48
75603131026,"Eschenbach (LU)",1933,916,1017,47.4
75603131030,"Hitzkirch",2376,1102,1274,46.4
75603131031,"Hochdorf",4064,1616,2448,39.8
75603131032,"Hohenrain",1292,656,636,50.8
75603131033,"Inwil",1175,578,597,49.2
75603131037,"Rain",1261,622,639,49.3
75603131039,"Römerswil",921,530,391,57.5
75603131040,"Rothenburg",4004,1726,2278,43.1
75603131041,"Schongau",485,286,199,59
75603121051,"Adligenswil",2872,1040,1832,36.2
75603121052,"Buchrain",2597,1119,1478,43.1
75603121053,"Dierikon",600,310,290,51.7
75603121054,"Ebikon",5377,2293,3084,42.6
75603121055,"Gisikon",516,270,246,52.3
75603121056,"Greppen",496,220,276,44.4
75603121057,"Honau",201,90,111,44.8
75603121058,"Horw",6673,2645,4028,39.6
75603121059,"Kriens",12442,5120,7322,41.2
75603111061,"Luzern",35289,10190,25099,28.9
75603121062,"Malters",3396,1651,1745,48.6
75603121063,"Meggen",3696,1427,2269,38.6
75603121064,"Meierskappel",601,314,287,52.2
75603121065,"Root",1766,831,935,47.1
75603121066,"Schwarzenberg",898,500,398,55.7
75603121067,"Udligenswil",1164,506,658,43.5
75603121068,"Vitznau",628,286,342,45.5
75603121069,"Weggis",2127,952,1175,44.8
75603141081,"Beromünster",2961,1421,1540,48
75603141082,"Büron",863,479,384,55.5
75603141083,"Buttisholz",1546,788,758,51
75603141084,"Eich",944,437,507,46.3
75603141085,"Geuensee",1069,528,541,49.4
75603141086,"Grosswangen",1455,765,690,52.6
75603141088,"Hildisrieden",1162,542,620,46.6
75603141089,"Knutwil",1043,505,538,48.4
75603141091,"Mauensee",650,275,375,42.3
75603141093,"Neuenkirch",3193,1508,1685,47.2
75603141094,"Nottwil",1776,817,959,46
75603141095,"Oberkirch",2137,830,1307,38.8
75603141097,"Rickenbach (LU)",1366,787,579,57.6
75603141098,"Ruswil",3448,1774,1674,51.5
75603141099,"Schenkon",1505,732,773,48.6
75603141100,"Schlierbach",399,203,196,50.9
75603141102,"Sempach",2251,777,1474,34.5
75603141103,"Sursee",4570,1574,2996,34.4
75603141104,"Triengen",1793,928,865,51.8
75603161107,"Wolhusen",1989,1060,929,53.3
75603151121,"Alberswil",299,179,120,59.9
75603151122,"Altbüron",470,249,221,53
75603151123,"Altishofen",648,304,344,46.9
75603151125,"Dagmersellen",2342,1215,1127,51.9
75603151126,"Ebersecken",203,138,65,68
75603151127,"Egolzwil",700,344,356,49.1
75603151128,"Ettiswil",1260,638,622,50.6
75603151129,"Fischbach",331,232,99,70.1
75603151130,"Gettnau",445,265,180,59.6
75603151131,"Grossdietwil",393,193,200,49.1
75603151132,"Hergiswil bei Willisau",890,583,307,65.5
75603151135,"Luthern",609,378,231,62.1
75603151136,"Menznau",1341,819,522,61.1
75603151137,"Nebikon",958,487,471,50.8
75603151139,"Pfaffnau",1095,581,514,53.1
75603151140,"Reiden",2797,1423,1374,50.9
75603151142,"Roggliswil",311,172,139,55.3
75603151143,"Schötz",1665,855,810,51.4
75603151145,"Ufhusen",442,274,168,62
75603151146,"Wauwil",813,429,384,52.8
75603151147,"Wikon",647,341,306,52.7
75603151150,"Zell (LU)",874,479,395,54.8
75603151151,"Willisau",3886,1911,1975,49.2
75604001201,"Altdorf (UR)",4670,1869,2801,40
75604001202,"Andermatt",684,323,361,47.2
75604001203,"Attinghausen",812,462,350,56.9
75604001204,"Bauen",103,53,50,51.5
75604001205,"Bürglen (UR)",2165,1178,987,54.4
75604001206,"Erstfeld",1776,922,854,51.9
75604001207,"Flüelen",1068,561,507,52.5
75604001208,"Göschenen",234,137,97,58.5
75604001209,"Gurtnellen",297,174,123,58.6
75604001210,"Hospental",102,54,48,52.9
75604001211,"Isenthal",269,138,131,51.3
75604001212,"Realp",105,44,61,41.9
75604001213,"Schattdorf",2781,1485,1296,53.4
75604001214,"Seedorf (UR)",983,533,450,54.2
75604001215,"Seelisberg",312,165,147,52.9
75604001216,"Silenen",1113,697,416,62.6
75604001217,"Sisikon",171,90,81,52.6
75604001218,"Spiringen",425,329,96,77.4
75604001219,"Unterschächen",394,300,94,76.1
75604001220,"Wassen",219,138,81,63
75605011301,"Einsiedeln",7471,3958,3513,53
75605021311,"Gersau",1055,495,560,46.9
75605031321,"Feusisberg",2243,1224,1019,54.6
75605031322,"Freienbach",6921,3444,3477,49.8
75605031323,"Wollerau",3342,1684,1658,50.4
75605041331,"Küssnacht (SZ)",5923,2723,3200,46
75605051341,"Altendorf",3045,1618,1427,53.1
75605051342,"Galgenen",2193,1262,931,57.5
75605051343,"Innerthal",110,71,39,64.5
75605051344,"Lachen",3358,1517,1841,45.2
75605051345,"Reichenburg",1363,854,509,62.7
75605051346,"Schübelbach",3228,1899,1329,58.8
75605051347,"Tuggen",1468,918,550,62.5
75605051348,"Vorderthal",516,419,97,81.2
75605051349,"Wangen (SZ)",2246,1246,1000,55.5
75605061361,"Alpthal",318,258,60,81.1
75605061362,"Arth",4811,2441,2370,50.7
75605061363,"Illgau",375,221,154,58.9
75605061364,"Ingenbohl",4274,2020,2254,47.3
75605061365,"Lauerz",581,362,219,62.3
75605061366,"Morschach",529,331,198,62.6
75605061367,"Muotathal",1824,1383,441,75.8
75605061368,"Oberiberg",521,335,186,64.3
75605061369,"Riemenstalden",35,25,10,71.4
75605061370,"Rothenthurm",1088,790,298,72.6
75605061371,"Sattel",925,594,331,64.2
75605061372,"Schwyz",7259,3594,3665,49.5
75605061373,"Steinen",1674,963,711,57.5
75605061374,"Steinerberg",445,292,153,65.6
75605061375,"Unteriberg",1231,1001,230,81.3
75606001401,"Alpnach",2897,1528,1369,52.7
75606001402,"Engelberg",1986,1011,975,50.9
75606001403,"Giswil",1766,1034,732,58.6
75606001404,"Kerns",2977,1787,1190,60
75606001405,"Lungern",1168,589,579,50.4
75606001406,"Sachseln",2570,1252,1318,48.7
75606001407,"Sarnen",5269,2588,2681,49.1
75607001501,"Beckenried",1867,1009,858,54
75607001502,"Buochs",2703,1341,1362,49.6
75607001503,"Dallenwil",1011,592,419,58.6
75607001504,"Emmetten",646,427,219,66.1
75607001505,"Ennetbürgen",2553,1292,1261,50.6
75607001506,"Ennetmoos",1099,661,438,60.1
75607001507,"Hergiswil (NW)",2803,1389,1414,49.6
75607001508,"Oberdorf (NW)",1777,918,859,51.7
75607001509,"Stans",4413,1832,2581,41.5
75607001510,"Stansstad",2277,1178,1099,51.7
75607001511,"Wolfenschiessen",1098,628,470,57.2
75608001630,"Glarus Nord",6396,3271,3125,51.1
75608001631,"Glarus Süd",4139,2127,2012,51.4
75608001632,"Glarus",4610,1983,2627,43
75609001701,"Baar",9737,4189,5548,43
75609001702,"Cham",6786,2822,3964,41.6
75609001703,"Hünenberg",4276,1712,2564,40
75609001704,"Menzingen",2123,1005,1118,47.3
75609001705,"Neuheim",991,529,462,53.4
75609001706,"Oberägeri",2543,1373,1170,54
75609001707,"Risch",4245,2024,2221,47.7
75609001708,"Steinhausen",4200,1620,2580,38.6
75609001709,"Unterägeri",3803,1921,1882,50.5
75609001710,"Walchwil",1550,790,760,51
75609001711,"Zug",12030,4304,7726,35.8
75610012004,"Bussy (FR)",193,108,85,56
75610012005,"Châbles",319,140,179,43.9
75610012008,"Châtillon (FR)",213,92,121,43.2
75610012009,"Cheiry",191,101,90,52.9
75610012010,"Cheyres",597,266,331,44.6
75610012011,"Cugy (FR)",752,370,382,49.2
75610012015,"Estavayer-le-Lac",2062,866,1196,42
75610012016,"Fétigny",385,184,201,47.8
75610012022,"Gletterens",484,253,231,52.3
75610012025,"Lully (FR)",447,224,223,50.1
75610012027,"Ménières",169,87,82,51.5
75610012029,"Montagny (FR)",1054,523,531,49.6
75610012033,"Morens (FR)",75,43,32,57.3
75610012034,"Murist",251,116,135,46.2
75610012035,"Nuvilly",178,101,77,56.7
75610012038,"Prévondavaux",27,18,9,66.7
75610012039,"Rueyres-les-Prés",185,83,102,44.9
75610012041,"Saint-Aubin (FR)",651,304,347,46.7
75610012043,"Sévaz",113,59,54,52.2
75610012044,"Surpierre",155,88,67,56.8
75610012045,"Vallon",165,68,97,41.2
75610012047,"Villeneuve (FR)",138,72,66,52.2
75610012049,"Vuissens",96,56,40,58.3
75610012050,"Les Montets",598,344,254,57.5
75610012051,"Delley-Portalban",566,292,274,51.6
75610012052,"Vernay",495,229,266,46.3
75610012053,"Belmont-Broye",1785,835,950,46.8
75610022061,"Auboranges",137,75,62,54.7
75610022063,"Billens-Hennens",329,160,169,48.6
75610022066,"Chapelle (Glâne)",131,66,65,50.4
75610022067,"Le Châtelard",169,102,67,60.4
75610022068,"Châtonnaye",327,133,194,40.7
75610022072,"Ecublens (FR)",178,90,88,50.6
75610022079,"Grangettes",96,62,34,64.6
75610022086,"Massonnens",240,123,117,51.3
75610022087,"Mézières (FR)",527,240,287,45.5
75610022089,"Montet (Glâne)",191,90,101,47.1
75610022096,"Romont (FR)",1522,608,914,39.9
75610022097,"Rue",609,279,330,45.8
75610022099,"Siviriez",951,462,489,48.6
75610022102,"Ursy",1164,605,559,52
75610022111,"Villaz-Saint-Pierre",507,259,248,51.1
75610022113,"Vuisternens-devant-Romont",1008,544,464,54
75610022114,"Villorsonnens",586,323,263,55.1
75610022115,"Torny",392,183,209,46.7
75610022116,"La Folliaz",465,196,269,42.2
75610032121,"Haut-Intyamon",646,286,360,44.3
75610032122,"Pont-en-Ogoz",870,370,500,42.5
75610032123,"Botterens",229,122,107,53.3
75610032124,"Broc",860,362,498,42.1
75610032125,"Bulle",6390,2418,3972,37.8
75610032128,"Châtel-sur-Montsalvens",107,49,58,45.8
75610032129,"Corbières",342,154,188,45
75610032130,"Crésuz",178,87,91,48.9
75610032131,"Echarlens",329,135,194,41
75610032134,"Grandvillard",357,143,214,40.1
75610032135,"Gruyères",839,329,510,39.2
75610032137,"Hauteville",260,122,138,46.9
75610032138,"Jaun",376,266,110,70.7
75610032140,"Marsens",709,257,452,36.2
75610032143,"Morlon",288,139,149,48.3
75610032145,"Le Pâquier (FR)",489,201,288,41.1
75610032147,"Pont-la-Ville",247,136,111,55.1
75610032148,"Riaz",1009,408,601,40.4
75610032149,"La Roche",618,351,267,56.8
75610032152,"Sâles",637,269,368,42.2
75610032153,"Sorens",494,240,254,48.6
75610032155,"Vaulruz",462,201,261,43.5
75610032160,"Vuadens",981,461,520,47
75610032162,"Bas-Intyamon",566,256,310,45.2
75610032163,"Val-de-Charmey",1150,541,609,47
75610042171,"Arconciel",356,129,227,36.2
75610042173,"Autigny",336,139,197,41.4
75610042174,"Avry",826,301,525,36.4
75610042175,"Belfaux",1137,432,705,38
75610042177,"Chénens",296,141,155,47.6
75610042179,"Chésopelloz",54,21,33,38.9
75610042183,"Corminboeuf",1127,367,760,32.6
75610042185,"Corserey",168,79,89,47
75610042186,"Cottens (FR)",616,242,374,39.3
75610042189,"Ependes (FR)",513,197,316,38.4
75610042194,"Ferpicloz",126,61,65,48.4
75610042196,"Fribourg",12329,3015,9314,24.5
75610042197,"Givisiez",1003,370,633,36.9
75610042198,"Granges-Paccot",1001,372,629,37.2
75610042200,"Grolley",746,334,412,44.8
75610042206,"Marly",3110,985,2125,31.7
75610042208,"Matran",672,227,445,33.8
75610042211,"Neyruz (FR)",1094,344,750,31.4
75610042213,"Noréaz",318,121,197,38.1
75610042216,"Pierrafortscha",71,27,44,38
75610042217,"Ponthaux",283,114,169,40.3
75610042220,"Le Mouret",1355,658,697,48.6
75610042221,"Prez-vers-Noréaz",407,176,231,43.2
75610042225,"Senèdes",75,33,42,44
75610042226,"Treyvaux",730,336,394,46
75610042228,"Villars-sur-Glâne",4279,1128,3151,26.4
75610042230,"Villarsel-sur-Marly",37,10,27,27
75610042233,"Hauterive (FR)",934,376,558,40.3
75610042234,"La Brillaz",805,312,493,38.8
75610042235,"La Sonnaz",437,169,268,38.7
75610042236,"Gibloux",2743,1113,1630,40.6
75610052243,"Barberêche",222,95,127,42.8
75610052250,"Courgevaux",522,196,326,37.5
75610052254,"Courtepin",880,396,484,45
75610052257,"Cressier (FR)",389,144,245,37
75610052258,"Fräschels",253,122,131,48.2
75610052259,"Galmiz",317,161,156,50.8
75610052260,"Gempenach",151,95,56,62.9
75610052261,"Greng",98,43,55,43.9
75610052262,"Gurmels",1904,889,1015,46.7
75610052265,"Kerzers",1968,835,1133,42.4
75610052266,"Kleinbösingen",347,176,171,50.7
75610052271,"Meyriez",335,125,210,37.3
75610052272,"Misery-Courtion",622,285,337,45.8
75610052274,"Muntelier",543,132,411,24.3
75610052275,"Murten",3546,1244,2302,35.1
75610052276,"Ried bei Kerzers",522,259,263,49.6
75610052278,"Ulmiz",227,131,96,57.7
75610052279,"Villarepos",251,125,126,49.8
75610052283,"Wallenried",198,91,107,46
75610052284,"Mont-Vully",1582,591,991,37.4
75610062291,"Alterswil",1064,510,554,47.9
75610062292,"Brünisried",334,191,143,57.2
75610062293,"Düdingen",3672,1454,2218,39.6
75610062294,"Giffers",679,375,304,55.2
75610062295,"Bösingen",1741,670,1071,38.5
75610062296,"Heitenried",717,322,395,44.9
75610062298,"Oberschrot",508,277,231,54.5
75610062299,"Plaffeien",881,544,337,61.7
75610062300,"Plasselb",528,361,167,68.4
75610062301,"Rechthalten",586,330,256,56.3
75610062302,"St. Antoni",979,488,491,49.8
75610062303,"St. Silvester",471,313,158,66.5
75610062304,"St. Ursen",676,312,364,46.2
75610062305,"Schmitten (FR)",1891,726,1165,38.4
75610062306,"Tafers",1539,593,946,38.5
75610062307,"Tentlingen",640,310,330,48.4
75610062308,"Ueberstorf",1286,659,627,51.2
75610062309,"Wünnewil-Flamatt",2305,905,1400,39.3
75610062310,"Zumholz",208,126,82,60.6
75610072321,"Attalens",1243,495,748,39.8
75610072323,"Bossonnens",512,209,303,40.8
75610072325,"Châtel-Saint-Denis",2291,1004,1287,43.8
75610072328,"Granges (Veveyse)",369,142,227,38.5
75610072333,"Remaufens",441,176,265,39.9
75610072335,"Saint-Martin (FR)",433,160,273,37
75610072336,"Semsales",634,368,266,58
75610072337,"Le Flon",523,264,259,50.5
75610072338,"La Verrerie",494,250,244,50.6
75611012401,"Egerkingen",1253,663,590,52.9
75611012402,"Härkingen",707,397,310,56.2
75611012403,"Kestenholz",912,408,504,44.7
75611012404,"Neuendorf",973,507,466,52.1
75611012405,"Niederbuchsiten",476,294,182,61.8
75611012406,"Oberbuchsiten",854,440,414,51.5
75611012407,"Oensingen",2168,1081,1087,49.9
75611012408,"Wolfwil",1002,499,503,49.8
75611022421,"Aedermannsdorf",313,158,155,50.5
75611022422,"Balsthal",2182,1052,1130,48.2
75611022423,"Gänsbrunnen",51,29,22,56.9
75611022424,"Herbetswil",261,138,123,52.9
75611022425,"Holderbank (SO)",280,161,119,57.5
75611022426,"Laupersdorf",800,422,378,52.8
75611022427,"Matzendorf",682,406,276,59.5
75611022428,"Mümliswil-Ramiswil",1242,758,484,61
75611022429,"Welschenrohr",536,265,271,49.4
75611032445,"Biezwil",156,78,78,50
75611032455,"Lüterkofen-Ichertswil",397,162,235,40.8
75611032456,"Lüterswil-Gächliwil",195,92,103,47.2
75611032457,"Messen",743,357,386,48
75611032461,"Schnottwil",536,275,261,51.3
75611032463,"Unterramsern",107,48,59,44.9
75611032464,"Lüsslingen-Nennigkofen",553,233,320,42.1
75611032465,"Buchegg",1357,575,782,42.4
75611042471,"Bättwil",513,200,313,39
75611042472,"Büren (SO)",450,223,227,49.6
75611042473,"Dornach",2745,879,1866,32
75611042474,"Gempen",388,160,228,41.2
75611042475,"Hochwald",696,281,415,40.4
75611042476,"Hofstetten-Flüh",1400,593,807,42.4
75611042477,"Metzerlen-Mariastein",508,245,263,48.2
75611042478,"Nuglar-St. Pantaleon",765,342,423,44.7
75611042479,"Rodersdorf",739,248,491,33.6
75611042480,"Seewen",480,239,241,49.8
75611042481,"Witterswil",701,290,411,41.4
75611052491,"Hauenstein-Ifenthal",162,68,94,42
75611052492,"Kienberg",261,133,128,51
75611052493,"Lostorf",1965,889,1076,45.2
75611052495,"Niedergösgen",1510,743,767,49.2
75611052497,"Obergösgen",898,442,456,49.2
75611052498,"Rohr (SO)",34,18,16,52.9
75611052499,"Stüsslingen",576,267,309,46.4
75611052500,"Trimbach",2037,849,1188,41.7
75611052501,"Winznau",853,376,477,44.1
75611052502,"Wisen (SO)",211,76,135,36
75611052503,"Erlinsbach (SO)",1523,611,912,40.1
75611062511,"Aeschi (SO)",696,313,383,45
75611062513,"Biberist",3387,1356,2031,40
75611062514,"Bolken",273,121,152,44.3
75611062516,"Deitingen",1151,500,651,43.4
75611062517,"Derendingen",2215,987,1228,44.6
75611062518,"Etziken",392,220,172,56.1
75611062519,"Gerlafingen",1526,682,844,44.7
75611062520,"Halten",441,182,259,41.3
75611062523,"Horriwil",466,222,244,47.6
75611062524,"Hüniken",57,27,30,47.4
75611062525,"Kriegstetten",657,328,329,49.9
75611062526,"Lohn-Ammannsegg",1460,581,879,39.8
75611062527,"Luterbach",1612,720,892,44.7
75611062528,"Obergerlafingen",516,276,240,53.5
75611062529,"Oekingen",438,193,245,44.1
75611062530,"Recherswil",908,459,449,50.6
75611062532,"Subingen",1371,627,744,45.7
75611062534,"Zuchwil",2721,1067,1654,39.2
75611062535,"Drei Höfe",395,184,211,46.6
75611072541,"Balm bei Günsberg",122,73,49,59.8
75611072542,"Bellach",2040,955,1085,46.8
75611072543,"Bettlach",2142,1074,1068,50.1
75611072544,"Feldbrunnen-St. Niklaus",580,182,398,31.4
75611072545,"Flumenthal",455,229,226,50.3
75611072546,"Grenchen",5263,2541,2722,48.3
75611072547,"Günsberg",631,330,301,52.3
75611072548,"Hubersdorf",376,142,234,37.8
75611072549,"Kammersrohr",23,6,17,26.1
75611072550,"Langendorf",1859,588,1271,31.6
75611072551,"Lommiswil",825,339,486,41.1
75611072553,"Oberdorf (SO)",938,334,604,35.6
75611072554,"Riedholz",1105,450,655,40.7
75611072555,"Rüttenen",850,305,545,35.9
75611072556,"Selzach",1502,764,738,50.9
75611082571,"Boningen",326,183,143,56.1
75611082572,"Däniken",1236,646,590,52.3
75611082573,"Dulliken",1594,745,849,46.7
75611082574,"Eppenberg-Wöschnau",101,56,45,55.4
75611082575,"Fulenbach",734,356,378,48.5
75611082576,"Gretzenbach",1215,588,627,48.4
75611082578,"Gunzgen",773,453,320,58.6
75611082579,"Hägendorf",2037,984,1053,48.3
75611082580,"Kappel (SO)",1360,592,768,43.5
75611082581,"Olten",7348,2120,5228,28.9
75611082582,"Rickenbach (SO)",427,221,206,51.8
75611082583,"Schönenwerd",1565,627,938,40.1
75611082584,"Starrkirch-Wil",876,264,612,30.1
75611082585,"Walterswil (SO)",316,190,126,60.1
75611082586,"Wangen bei Olten",2060,784,1276,38.1
75611092601,"Solothurn",8145,1929,6216,23.7
75611102611,"Bärschwil",423,218,205,51.5
75611102612,"Beinwil (SO)",130,63,67,48.5
75611102613,"Breitenbach",1372,667,705,48.6
75611102614,"Büsserach",960,496,464,51.7
75611102615,"Erschwil",431,222,209,51.5
75611102616,"Fehren",279,149,130,53.4
75611102617,"Grindel",223,135,88,60.5
75611102618,"Himmelried",467,210,257,45
75611102619,"Kleinlützel",553,275,278,49.7
75611102620,"Meltingen",324,147,177,45.4
75611102621,"Nunningen",970,538,432,55.5
75611102622,"Zullwil",279,162,117,58.1
75612002701,"Basel",62165,17827,44338,28.7
75612002702,"Bettingen",544,195,349,35.8
75612002703,"Riehen",9329,3467,5862,37.2
75613012761,"Aesch (BL)",3777,1578,2199,41.8
75613012762,"Allschwil",7975,3080,4895,38.6
75613012763,"Arlesheim",4160,1154,3006,27.7
75613012764,"Biel-Benken",1661,657,1004,39.6
75613012765,"Binningen",6495,2184,4311,33.6
75613012766,"Birsfelden",3724,1469,2255,39.4
75613012767,"Bottmingen",2904,1014,1890,34.9
75613012768,"Ettingen",2269,949,1320,41.8
75613012769,"Münchenstein",4790,1703,3087,35.6
75613012770,"Muttenz",7340,2799,4541,38.1
75613012771,"Oberwil (BL)",4675,1637,3038,35
75613012772,"Pfeffingen",1241,553,688,44.6
75613012773,"Reinach (BL)",7722,3202,4520,41.5
75613012774,"Schönenbuch",727,300,427,41.3
75613012775,"Therwil",4410,1717,2693,38.9
75613022781,"Blauen",374,192,182,51.3
75613022782,"Brislach",699,426,273,60.9
75613022783,"Burg im Leimental",132,59,73,44.7
75613022784,"Dittingen",317,149,168,47
75613022785,"Duggingen",614,278,336,45.3
75613022786,"Grellingen",718,321,397,44.7
75613022787,"Laufen",2206,905,1301,41
75613022788,"Liesberg",555,340,215,61.3
75613022789,"Nenzlingen",201,124,77,61.7
75613022790,"Roggenburg",136,91,45,66.9
75613022791,"Röschenz",950,494,456,52
75613022792,"Wahlen",682,404,278,59.2
75613022793,"Zwingen",804,364,440,45.3
75613032821,"Arisdorf",759,390,369,51.4
75613032822,"Augst",460,222,238,48.3
75613032823,"Bubendorf",2130,856,1274,40.2
75613032824,"Frenkendorf",2133,882,1251,41.4
75613032825,"Füllinsdorf",1663,705,958,42.4
75613032826,"Giebenach",409,240,169,58.7
75613032827,"Hersberg",156,77,79,49.4
75613032828,"Lausen",1869,828,1041,44.3
75613032829,"Liestal",5251,1675,3576,31.9
75613032830,"Lupsingen",683,273,410,40
75613032831,"Pratteln",4436,1804,2632,40.7
75613032832,"Ramlinsburg",390,145,245,37.2
75613032833,"Seltisberg",764,292,472,38.2
75613032834,"Ziefen",744,282,462,37.9
75613042841,"Anwil",290,135,155,46.6
75613042842,"Böckten",409,189,220,46.2
75613042843,"Buckten",330,148,182,44.8
75613042844,"Buus",514,280,234,54.5
75613042845,"Diepflingen",306,166,140,54.2
75613042846,"Gelterkinden",2516,921,1595,36.6
75613042847,"Häfelfingen",128,59,69,46.1
75613042848,"Hemmiken",134,81,53,60.4
75613042849,"Itingen",911,391,520,42.9
75613042850,"Känerkinden",251,123,128,49
75613042851,"Kilchberg (BL)",84,30,54,35.7
75613042852,"Läufelfingen",621,279,342,44.9
75613042853,"Maisprach",516,222,294,43
75613042854,"Nusshof",137,61,76,44.5
75613042855,"Oltingen",250,98,152,39.2
75613042856,"Ormalingen",993,455,538,45.8
75613042857,"Rickenbach (BL)",296,130,166,43.9
75613042858,"Rothenfluh",390,172,218,44.1
75613042859,"Rümlingen",164,99,65,60.4
75613042860,"Rünenberg",432,189,243,43.8
75613042861,"Sissach",2997,1057,1940,35.3
75613042862,"Tecknau",286,138,148,48.3
75613042863,"Tenniken",423,174,249,41.1
75613042864,"Thürnen",576,294,282,51
75613042865,"Wenslingen",399,166,233,41.6
75613042866,"Wintersingen",330,159,171,48.2
75613042867,"Wittinsburg",223,99,124,44.4
75613042868,"Zeglingen",256,106,150,41.4
75613042869,"Zunzgen",1129,544,585,48.2
75613052881,"Arboldswil",315,174,141,55.2
75613052882,"Bennwil",299,174,125,58.2
75613052883,"Bretzwil",384,233,151,60.7
75613052884,"Diegten",746,402,344,53.9
75613052885,"Eptingen",252,139,113,55.2
75613052886,"Hölstein",1082,438,644,40.5
75613052887,"Lampenberg",285,136,149,47.7
75613052888,"Langenbruck",426,196,230,46
75613052889,"Lauwil",169,88,81,52.1
75613052890,"Liedertswil",88,56,32,63.6
75613052891,"Niederdorf",625,314,311,50.2
75613052892,"Oberdorf (BL)",933,408,525,43.7
75613052893,"Reigoldswil",686,280,406,40.8
75613052894,"Titterten",222,94,128,42.3
75613052895,"Waldenburg",389,222,167,57.1
75614012901,"Gächlingen",509,279,230,54.8
75614012903,"Löhningen",759,376,383,49.5
75614012904,"Neunkirch",1106,500,606,45.2
75614022914,"Büttenhardt",211,111,100,52.6
75614022915,"Dörflingen",546,299,247,54.8
75614022917,"Lohn (SH)",434,245,189,56.5
75614022919,"Stetten (SH)",701,302,399,43.1
75614022920,"Thayngen",2650,1440,1210,54.3
75614032931,"Bargen (SH)",156,102,54,65.4
75614032932,"Beringen",2267,1151,1116,50.8
75614032933,"Buchberg",525,265,260,50.5
75614032936,"Merishausen",470,261,209,55.5
75614032937,"Neuhausen am Rheinfall",3644,1637,2007,44.9
75614032938,"Rüdlingen",473,238,235,50.3
75614032939,"Schaffhausen",16292,6168,10124,37.9
75614042951,"Beggingen",305,205,100,67.2
75614042952,"Schleitheim",869,465,404,53.5
75614042953,"Siblingen",474,221,253,46.6
75614052961,"Buch (SH)",160,105,55,65.6
75614052962,"Hemishofen",265,137,128,51.7
75614052963,"Ramsen",660,386,274,58.5
75614052964,"Stein am Rhein",1665,728,937,43.7
75614062971,"Hallau",1143,599,544,52.4
75614062972,"Oberhallau",260,165,95,63.5
75614062973,"Trasadingen",274,159,115,58
75614062974,"Wilchingen",953,487,466,51.1
75615013001,"Herisau",6403,2793,3610,43.6
75615013002,"Hundwil",436,273,163,62.6
75615013003,"Schönengrund",261,168,93,64.4
75615013004,"Schwellbrunn",754,477,277,63.3
75615013005,"Stein (AR)",753,377,376,50.1
75615013006,"Urnäsch",1070,647,423,60.5
75615013007,"Waldstatt",812,428,384,52.7
75615023021,"Bühler",692,362,330,52.3
75615023022,"Gais",1550,635,915,41
75615023023,"Speicher",2262,832,1430,36.8
75615023024,"Teufen (AR)",3347,1287,2060,38.5
75615023025,"Trogen",975,269,706,27.6
75615033031,"Grub (AR)",495,242,253,48.9
75615033032,"Heiden",1864,807,1057,43.3
75615033033,"Lutzenberg",604,343,261,56.8
75615033034,"Rehetobel",939,346,593,36.8
75615033035,"Reute (AR)",340,176,164,51.8
75615033036,"Wald (AR)",428,194,234,45.3
75615033037,"Walzenhausen",841,420,421,49.9
75615033038,"Wolfhalden",803,377,426,46.9
75616003101,"Appenzell",2214,1083,1131,48.9
75616003102,"Gonten",649,424,225,65.3
75616003103,"Rüte",1570,896,674,57.1
75616003104,"Schlatt-Haslen",481,261,220,54.3
75616003105,"Schwende",825,472,353,57.2
75616003111,"Oberegg",917,491,426,53.5
75617213201,"Häggenschwil",601,313,288,52.1
75617213202,"Muolen",551,280,271,50.8
75617213203,"St. Gallen",28412,8263,20149,29.1
75617213204,"Wittenbach",3638,1626,2012,44.7
75617223211,"Berg (SG)",453,210,243,46.4
75617213212,"Eggersriet",1110,484,626,43.6
75617223213,"Goldach",3509,1576,1933,44.9
75617223214,"Mörschwil",1905,763,1142,40.1
75617223215,"Rorschach",2271,815,1456,35.9
75617223216,"Rorschacherberg",2836,1314,1522,46.3
75617223217,"Steinach",1332,605,727,45.4
75617223218,"Tübach",630,266,364,42.2
75617223219,"Untereggen",514,234,280,45.5
75617233231,"Au (SG)",2351,1197,1154,50.9
75617233232,"Balgach",1745,763,982,43.7
75617233233,"Berneck",1617,860,757,53.2
75617233234,"Diepoldsau",2298,1158,1140,50.4
75617233235,"Rheineck",1111,545,566,49.1
75617233236,"St. Margrethen",1426,801,625,56.2
75617223237,"Thal",2614,1393,1221,53.3
75617233238,"Widnau",3289,1699,1590,51.7
75617233251,"Altstätten",3986,2062,1924,51.7
75617233252,"Eichberg",644,387,257,60.1
75617233253,"Marbach (SG)",875,458,417,52.3
75617233254,"Oberriet (SG)",3643,2293,1350,62.9
75617233255,"Rebstein",1484,768,716,51.8
75617233256,"Rüthi (SG)",863,504,359,58.4
75617243271,"Buchs (SG)",3805,1662,2143,43.7
75617243272,"Gams",1387,696,691,50.2
75617243273,"Grabs",2996,1359,1637,45.4
75617243274,"Sennwald",1886,1052,834,55.8
75617243275,"Sevelen",1534,794,740,51.8
75617243276,"Wartau",1881,923,958,49.1
75617253291,"Bad Ragaz",2161,973,1188,45
75617253292,"Flums",1839,1151,688,62.6
75617253293,"Mels",3588,2068,1520,57.6
75617253294,"Pfäfers",706,375,331,53.1
75617253295,"Quarten",1123,653,470,58.1
75617253296,"Sargans",2299,1023,1276,44.5
75617253297,"Vilters-Wangs",2031,1021,1010,50.3
75617253298,"Walenstadt",2238,1087,1151,48.6
75617263311,"Amden",890,483,407,54.3
75617263312,"Benken (SG)",1241,757,484,61
75617263313,"Kaltbrunn",1749,1001,748,57.2
75617263315,"Schänis",1552,904,648,58.2
75617263316,"Weesen",718,319,399,44.4
75617263338,"Schmerikon",1429,626,803,43.8
75617263339,"Uznach",2220,991,1229,44.6
75617263340,"Rapperswil-Jona",11769,4518,7251,38.4
75617263341,"Gommiswald",2266,1287,979,56.8
75617263342,"Eschenbach (SG)",3792,2148,1644,56.6
75617273352,"Ebnat-Kappel",2283,1160,1123,50.8
75617273359,"Wildhaus-Alt St. Johann",1115,614,501,55.1
75617273360,"Nesslau",1710,995,715,58.2
75617273372,"Hemberg",451,265,186,58.8
75617273374,"Lichtensteig",800,332,468,41.5
75617273375,"Oberhelfenschwil",627,332,295,53
75617273378,"Neckertal",1805,1017,788,56.3
75617273379,"Wattwil",3369,1552,1817,46.1
75617273392,"Kirchberg (SG)",3177,1717,1460,54
75617273393,"Lütisburg",667,371,296,55.6
75617273394,"Mosnang",1383,845,538,61.1
75617273395,"Bütschwil-Ganterschwil",1905,1047,858,55
75617283401,"Degersheim",1578,651,927,41.3
75617283402,"Flawil",3591,1508,2083,42
75617283405,"Jonschwil",1587,850,737,53.6
75617283407,"Oberuzwil",2623,1163,1460,44.3
75617283408,"Uzwil",4406,2073,2333,47
75617283422,"Niederbüren",690,421,269,61
75617283423,"Niederhelfenschwil",1368,742,626,54.2
75617283424,"Oberbüren",1841,1080,761,58.7
75617283426,"Zuzwil (SG)",2200,1080,1120,49.1
75617283427,"Wil (SG)",8980,3599,5381,40.1
75617213441,"Andwil (SG)",1063,507,556,47.7
75617213442,"Gaiserwald",3781,1624,2157,43
75617213443,"Gossau (SG)",7571,3656,3915,48.3
75617213444,"Waldkirch",1586,896,690,56.5
75618213503,"Mutten",42,24,18,57.1
75618213506,"Vaz/Obervaz",1168,454,714,38.9
75618213513,"Lantsch/Lenz",193,66,127,34.2
75618213514,"Schmitten (GR)",118,56,62,47.5
75618213521,"Bergün/Bravuogn",205,73,132,35.6
75618213522,"Filisur",189,62,127,32.8
75618213542,"Albula/Alvra",553,210,343,38
75618213543,"Surses",942,343,599,36.4
75618223551,"Brusio",457,262,195,57.3
75618223561,"Poschiavo",1656,835,821,50.4
75618313572,"Falera",305,115,190,37.7
75618313575,"Laax",722,293,429,40.6
75618313581,"Sagogn",309,113,196,36.6
75618313582,"Schluein",195,70,125,35.9
75618313603,"Vals",450,123,327,27.3
75618313611,"Andiast",58,29,29,50
75618313616,"Waltensburg/Vuorz",158,50,108,31.6
75618313618,"Lumnezia",993,449,544,45.2
75618313619,"Ilanz/Glion",1841,806,1035,43.8
75618233633,"Fürstenau",179,67,112,37.4
75618233637,"Rothenbrunnen",152,61,91,40.1
75618233638,"Scharans",469,180,289,38.4
75618233640,"Sils im Domleschg",377,188,189,49.9
75618233661,"Cazis",897,424,473,47.3
75618233662,"Flerden",110,38,72,34.5
75618233663,"Masein",260,80,180,30.8
75618233668,"Thusis",1006,428,578,42.5
75618233669,"Tschappina",74,15,59,20.3
75618233670,"Urmein",87,29,58,33.3
75618313672,"Safiental",446,168,278,37.7
75618233673,"Domleschg",1059,367,692,34.7
75618233681,"Avers",96,46,50,47.9
75618233691,"Hinterrhein",42,11,31,26.2
75618233693,"Nufenen",73,34,39,46.6
75618233694,"Splügen",224,103,121,46
75618233695,"Sufers",75,30,45,40
75618233701,"Andeer",448,184,264,41.1
75618233703,"Casti-Wergenstein",27,10,17,37
75618233705,"Donat",108,31,77,28.7
75618233707,"Lohn (GR)",29,8,21,27.6
75618233708,"Mathon",28,9,19,32.1
75618233711,"Rongellen",30,17,13,56.7
75618233712,"Zillis-Reischen",166,81,85,48.8
75618233713,"Ferrera",47,19,28,40.4
75618243721,"Bonaduz",1462,615,847,42.1
75618243722,"Domat/Ems",3009,1260,1749,41.9
75618243723,"Rhäzüns",516,204,312,39.5
75618243731,"Felsberg",1126,469,657,41.7
75618243732,"Flims",1269,427,842,33.6
75618243733,"Tamins",580,216,364,37.2
75618243734,"Trin",621,152,469,24.5
75618253746,"Zernez",664,278,386,41.9
75618253752,"Samnaun",234,117,117,50
75618253762,"Scuol",1728,572,1156,33.1
75618253764,"Valsot",325,127,198,39.1
75618273781,"Bever",310,113,197,36.5
75618273782,"Celerina/Schlarigna",533,170,363,31.9
75618273783,"Madulain",101,45,56,44.6
75618273784,"Pontresina",739,285,454,38.6
75618273785,"La Punt-Chamues-ch",256,104,152,40.6
75618273786,"Samedan",1226,439,787,35.8
75618273787,"St. Moritz",1546,626,920,40.5
75618273788,"S-chanf",276,122,154,44.2
75618273789,"Sils im Engadin/Segl",249,74,175,29.7
75618273790,"Silvaplana",335,141,194,42.1
75618273791,"Zuoz",463,180,283,38.9
75618273792,"Bregaglia",697,308,389,44.2
75618283804,"Buseno",47,34,13,72.3
75618283805,"Castaneda",135,70,65,51.9
75618283808,"Rossa",96,75,21,78.1
75618283810,"Santa Maria in Calanca",62,46,16,74.2
75618283821,"Lostallo",374,260,114,69.5
75618283822,"Mesocco",606,391,215,64.5
75618283823,"Soazza",186,119,67,64
75618283831,"Cama",213,152,61,71.4
75618283832,"Grono",397,238,159,59.9
75618283833,"Leggia",77,63,14,81.8
75618283834,"Roveredo (GR)",1040,718,322,69
75618283835,"San Vittore",348,211,137,60.6
75618283836,"Verdabbio",68,22,46,32.4
75618283837,"Calanca",96,48,48,50
75618253847,"Val Müstair",736,331,405,45
75618303851,"Davos",4247,1683,2564,39.6
75618303861,"Fideris",263,127,136,48.3
75618303862,"Furna",90,52,38,57.8
75618303863,"Jenaz",450,227,223,50.4
75618303871,"Klosters-Serneus",1936,967,969,49.9
75618303881,"Conters im Prättigau",83,49,34,59
75618303882,"Küblis",303,195,108,64.4
75618303891,"Luzein",657,375,282,57.1
75618293901,"Chur",14770,5287,9483,35.8
75618293911,"Churwalden",863,359,504,41.6
75618293921,"Arosa",1361,613,748,45
75618293926,"Maladers",235,140,95,59.6
75618293932,"Tschiertschen-Praden",125,40,85,32
75618263941,"Haldenstein",450,158,292,35.1
75618263945,"Trimmis",1485,750,735,50.5
75618263946,"Untervaz",982,474,508,48.3
75618263947,"Zizers",1343,544,799,40.5
75618263951,"Fläsch",363,162,201,44.6
75618263952,"Jenins",459,202,257,44
75618263953,"Maienfeld",1335,517,818,38.7
75618263954,"Malans",1195,384,811,32.1
75618263955,"Landquart",3436,1522,1914,44.3
75618303961,"Grüsch",900,454,446,50.4
75618303962,"Schiers",1021,527,494,51.6
75618303972,"Seewis im Prättigau",538,278,260,51.7
75618313981,"Breil/Brigels",520,225,295,43.3
75618313982,"Disentis/Mustér",1006,420,586,41.7
75618313983,"Medel (Lucmagn)",207,88,119,42.5
75618313985,"Sumvitg",611,204,407,33.4
75618313986,"Tujetsch",627,265,362,42.3
75618313987,"Trun",541,197,344,36.4
75618313988,"Obersaxen Mundaun",537,255,282,47.5
75619014001,"Aarau",9848,2870,6978,29.1
75619014002,"Biberstein",861,338,523,39.3
75619014003,"Buchs (AG)",2733,1136,1597,41.6
75619014004,"Densbüren",369,215,154,58.3
75619014005,"Erlinsbach (AG)",1941,821,1120,42.3
75619014006,"Gränichen",3069,1532,1537,49.9
75619014007,"Hirschthal",783,430,353,54.9
75619014008,"Küttigen",3051,1041,2010,34.1
75619014009,"Muhen",1699,886,813,52.1
75619014010,"Oberentfelden",3049,1427,1622,46.8
75619014012,"Suhr",3484,1359,2125,39
75619014013,"Unterentfelden",1695,687,1008,40.5
75619024021,"Baden",8146,2030,6116,24.9
75619024022,"Bellikon",854,368,486,43.1
75619024023,"Bergdietikon",1290,610,680,47.3
75619024024,"Birmenstorf (AG)",1302,570,732,43.8
75619024026,"Ennetbaden",1658,316,1342,19.1
75619024027,"Fislisbach",2117,851,1266,40.2
75619024028,"Freienwil",491,187,304,38.1
75619024029,"Gebenstorf",1993,788,1205,39.5
75619024030,"Killwangen",758,314,444,41.4
75619024031,"Künten",728,340,388,46.7
75619024032,"Mägenwil",802,427,375,53.2
75619024033,"Mellingen",1846,790,1056,42.8
75619024034,"Neuenhof",2084,952,1132,45.7
75619024035,"Niederrohrdorf",1714,672,1042,39.2
75619024037,"Oberrohrdorf",2019,778,1241,38.5
75619024038,"Obersiggenthal",3384,1111,2273,32.8
75619024039,"Remetschwil",988,465,523,47.1
75619024040,"Spreitenbach",2237,1045,1192,46.7
75619024041,"Stetten (AG)",832,388,444,46.6
75619024042,"Turgi",874,293,581,33.5
75619024044,"Untersiggenthal",2847,1107,1740,38.9
75619024045,"Wettingen",8305,2861,5444,34.4
75619024046,"Wohlenschwil",685,323,362,47.2
75619024047,"Würenlingen",1818,902,916,49.6
75619024048,"Würenlos",2804,1152,1652,41.1
75619024049,"Ehrendingen",2009,862,1147,42.9
75619034061,"Arni (AG)",916,380,536,41.5
75619034062,"Berikon",2068,911,1157,44.1
75619034063,"Bremgarten (AG)",3256,1366,1890,42
75619034064,"Büttikon",431,238,193,55.2
75619034065,"Dottikon",1228,622,606,50.7
75619034066,"Eggenwil",456,197,259,43.2
75619034067,"Fischbach-Göslikon",713,395,318,55.4
75619034068,"Hägglingen",1093,531,562,48.6
75619034071,"Jonen",990,411,579,41.5
75619034072,"Niederwil (AG)",1202,604,598,50.2
75619034073,"Oberlunkhofen",986,431,555,43.7
75619034074,"Oberwil-Lieli",1205,553,652,45.9
75619034075,"Rudolfstetten-Friedlisberg",1644,777,867,47.3
75619034076,"Sarmenstorf",1218,604,614,49.6
75619034077,"Tägerig",634,314,320,49.5
75619034078,"Uezwil",227,130,97,57.3
75619034079,"Unterlunkhofen",671,318,353,47.4
75619034080,"Villmergen",2429,1358,1071,55.9
75619034081,"Widen",1800,725,1075,40.3
75619034082,"Wohlen (AG)",5031,2345,2686,46.6
75619034083,"Zufikon",1960,931,1029,47.5
75619034084,"Islisberg",304,142,162,46.7
75619044091,"Auenstein",790,334,456,42.3
75619044092,"Birr",1080,528,552,48.9
75619044093,"Birrhard",336,189,147,56.3
75619044094,"Bözen",341,190,151,55.7
75619044095,"Brugg",4583,1502,3081,32.8
75619044096,"Effingen",276,147,129,53.3
75619044097,"Elfingen",134,56,78,41.8
75619044099,"Habsburg",237,105,132,44.3
75619044100,"Hausen (AG)",1487,720,767,48.4
75619044104,"Lupfig",1046,510,536,48.8
75619044105,"Mandach",156,94,62,60.3
75619044106,"Mönthal",198,114,84,57.6
75619044107,"Mülligen",462,209,253,45.2
75619044110,"Remigen",490,239,251,48.8
75619044111,"Riniken",699,280,419,40.1
75619044112,"Rüfenach",477,209,268,43.8
75619044113,"Scherz",328,167,161,50.9
75619044114,"Schinznach-Bad",474,219,255,46.2
75619044117,"Thalheim (AG)",399,219,180,54.9
75619044120,"Veltheim (AG)",631,279,352,44.2
75619044121,"Villigen",850,418,432,49.2
75619044122,"Villnachern",741,335,406,45.2
75619044123,"Windisch",2797,950,1847,34
75619044124,"Bözberg",829,436,393,52.6
75619044125,"Schinznach",1040,486,554,46.7
75619054131,"Beinwil am See",1477,703,774,47.6
75619054132,"Birrwil",591,293,298,49.6
75619054133,"Burg (AG)",317,174,143,54.9
75619054134,"Dürrenäsch",597,391,206,65.5
75619054135,"Gontenschwil",884,506,378,57.2
75619054136,"Holziken",533,341,192,64
75619054137,"Leimbach (AG)",234,127,107,54.3
75619054138,"Leutwil",412,277,135,67.2
75619054139,"Menziken",1804,1001,803,55.5
75619054140,"Oberkulm",1108,645,463,58.2
75619054141,"Reinach (AG)",2313,1310,1003,56.6
75619054142,"Schlossrued",382,252,130,66
75619054143,"Schmiedrued",508,335,173,65.9
75619054144,"Schöftland",1885,947,938,50.2
75619054145,"Teufenthal (AG)",601,331,270,55.1
75619054146,"Unterkulm",1120,597,523,53.3
75619054147,"Zetzwil",632,387,245,61.2
75619064161,"Eiken",842,442,400,52.5
75619064163,"Frick",2052,929,1123,45.3
75619064164,"Gansingen",511,254,257,49.7
75619064165,"Gipf-Oberfrick",1631,606,1025,37.2
75619064166,"Herznach",712,370,342,52
75619064167,"Hornussen",392,205,187,52.3
75619064169,"Kaisten",1071,499,572,46.6
75619064170,"Laufenburg",1248,533,715,42.7
75619064172,"Münchwilen (AG)",363,191,172,52.6
75619064173,"Oberhof",295,150,145,50.8
75619064175,"Oeschgen",411,206,205,50.1
75619064176,"Schwaderloch",257,148,109,57.6
75619064177,"Sisseln",507,302,205,59.6
75619064179,"Ueken",373,184,189,49.3
75619064181,"Wittnau",577,284,293,49.2
75619064182,"Wölflinswil",488,255,233,52.3
75619064183,"Zeihen",507,264,243,52.1
75619064184,"Mettauertal",910,469,441,51.5
75619074191,"Ammerswil",325,147,178,45.2
75619074192,"Boniswil",707,363,344,51.3
75619074193,"Brunegg",296,152,144,51.4
75619074194,"Dintikon",818,462,356,56.5
75619074195,"Egliswil",673,329,344,48.9
75619074196,"Fahrwangen",779,389,390,49.9
75619074197,"Hallwil",345,218,127,63.2
75619074198,"Hendschiken",474,254,220,53.6
75619074199,"Holderbank (AG)",374,219,155,58.6
75619074200,"Hunzenschwil",1317,731,586,55.5
75619074201,"Lenzburg",3725,1136,2589,30.5
75619074202,"Meisterschwanden",1342,691,651,51.5
75619074203,"Möriken-Wildegg",1908,834,1074,43.7
75619074204,"Niederlenz",1583,631,952,39.9
75619074205,"Othmarsingen",1044,525,519,50.3
75619074206,"Rupperswil",2164,1056,1108,48.8
75619074207,"Schafisheim",1287,601,686,46.7
75619074208,"Seengen",1871,904,967,48.3
75619074209,"Seon",1980,1011,969,51.1
75619074210,"Staufen",1450,545,905,37.6
75619084221,"Abtwil",424,221,203,52.1
75619084222,"Aristau",641,316,325,49.3
75619084223,"Auw",718,382,336,53.2
75619084224,"Beinwil (Freiamt)",510,279,231,54.7
75619084226,"Besenbüren",297,151,146,50.8
75619084227,"Bettwil",278,138,140,49.6
75619084228,"Boswil",1070,626,444,58.5
75619084229,"Bünzen",463,249,214,53.8
75619084230,"Buttwil",554,282,272,50.9
75619084231,"Dietwil",574,330,244,57.5
75619084232,"Geltwil",86,42,44,48.8
75619084233,"Kallern",166,93,73,56
75619084234,"Merenschwand",1520,733,787,48.2
75619084235,"Mühlau",484,282,202,58.3
75619084236,"Muri (AG)",3038,1329,1709,43.7
75619084237,"Oberrüti",707,315,392,44.6
75619084238,"Rottenschwil",421,235,186,55.8
75619084239,"Sins",1862,921,941,49.5
75619084240,"Waltenschwil",1270,641,629,50.5
75619094251,"Hellikon",388,243,145,62.6
75619094252,"Kaiseraugst",1801,798,1003,44.3
75619094253,"Magden",1749,674,1075,38.5
75619094254,"Möhlin",3771,1716,2055,45.5
75619094255,"Mumpf",447,238,209,53.2
75619094256,"Obermumpf",455,213,242,46.8
75619094257,"Olsberg",183,89,94,48.6
75619094258,"Rheinfelden",4462,1577,2885,35.3
75619094259,"Schupfart",370,210,160,56.8
75619094260,"Stein (AG)",875,420,455,48
75619094261,"Wallbach",855,417,438,48.8
75619094262,"Wegenstetten",469,231,238,49.3
75619094263,"Zeiningen",943,403,540,42.7
75619094264,"Zuzgen",378,171,207,45.2
75619104271,"Aarburg",2035,962,1073,47.3
75619104272,"Attelwil",158,102,56,64.6
75619104273,"Bottenwil",388,214,174,55.2
75619104274,"Brittnau",1962,1040,922,53
75619104275,"Kirchleerau",409,244,165,59.7
75619104276,"Kölliken",1724,851,873,49.4
75619104277,"Moosleerau",402,238,164,59.2
75619104279,"Murgenthal",1147,656,491,57.2
75619104280,"Oftringen",4082,1903,2179,46.6
75619104281,"Reitnau",597,333,264,55.8
75619104282,"Rothrist",3144,1626,1518,51.7
75619104283,"Safenwil",1469,821,648,55.9
75619104284,"Staffelbach",500,297,203,59.4
75619104285,"Strengelbach",1756,854,902,48.6
75619104286,"Uerkheim",661,396,265,59.9
75619104287,"Vordemwald",940,489,451,52
75619104288,"Wiliberg",98,60,38,61.2
75619104289,"Zofingen",5411,1974,3437,36.5
75619114301,"Baldingen",135,73,62,54.1
75619114302,"Böbikon",92,45,47,48.9
75619114303,"Böttstein",1237,716,521,57.9
75619114304,"Döttingen",1190,604,586,50.8
75619114305,"Endingen",1130,449,681,39.7
75619114306,"Fisibach",161,89,72,55.3
75619114307,"Full-Reuenthal",379,200,179,52.8
75619114308,"Kaiserstuhl",164,52,112,31.7
75619114309,"Klingnau",1263,535,728,42.4
75619114310,"Koblenz",460,248,212,53.9
75619114311,"Leibstadt",473,282,191,59.6
75619114312,"Lengnau (AG)",1183,552,631,46.7
75619114313,"Leuggern",994,594,400,59.8
75619114314,"Mellikon",117,47,70,40.2
75619114315,"Rekingen (AG)",315,179,136,56.8
75619114316,"Rietheim",234,103,131,44
75619114317,"Rümikon",103,55,48,53.4
75619114318,"Schneisingen",714,332,382,46.5
75619114319,"Siglistorf",249,144,105,57.8
75619114320,"Tegerfelden",521,282,239,54.1
75619114322,"Wislikofen",181,79,102,43.6
75619114323,"Bad Zurzach",1393,627,766,45
75620114401,"Arbon",4476,1990,2486,44.5
75620114406,"Dozwil",294,199,95,67.7
75620114411,"Egnach",1950,989,961,50.7
75620114416,"Hefenhofen",465,230,235,49.5
75620114421,"Horn",1088,476,612,43.8
75620114426,"Kesswil",449,196,253,43.7
75620114431,"Roggwil (TG)",1197,624,573,52.1
75620114436,"Romanshorn",3363,1474,1889,43.8
75620114441,"Salmsach",451,247,204,54.8
75620114446,"Sommeri",225,130,95,57.8
75620114451,"Uttwil",781,400,381,51.2
75620114461,"Amriswil",3792,1833,1959,48.3
75620154471,"Bischofszell",2058,967,1091,47
75620154476,"Erlen",1173,652,521,55.6
75620154486,"Hauptwil-Gottshaus",756,422,334,55.8
75620154495,"Hohentannen",246,156,90,63.4
75620154501,"Kradolf-Schönenberg",1271,642,629,50.5
75620154506,"Sulgen",1342,693,649,51.6
75620154511,"Zihlschlacht-Sitterdorf",909,512,397,56.3
75620124536,"Basadingen-Schlattingen",819,454,365,55.4
75620124545,"Diessenhofen",1256,578,678,46
75620124546,"Schlatt (TG)",762,443,319,58.1
75620144551,"Aadorf",3684,1764,1920,47.9
75620124561,"Felben-Wellhausen",941,542,399,57.6
75620124566,"Frauenfeld",9801,3617,6184,36.9
75620124571,"Gachnang",1688,819,869,48.5
75620124590,"Hüttlingen",388,208,180,53.6
75620124591,"Matzingen",867,412,455,47.5
75620124601,"Neunforn",482,252,230,52.3
75620124606,"Stettfurt",550,253,297,46
75620124611,"Thundorf",634,287,347,45.3
75620124616,"Uesslingen-Buch",540,305,235,56.5
75620124621,"Warth-Weiningen",607,327,280,53.9
75620134641,"Altnau",891,368,523,41.3
75620134643,"Bottighofen",839,310,529,36.9
75620134646,"Ermatingen",1190,451,739,37.9
75620134651,"Gottlieben",114,39,75,34.2
75620134656,"Güttingen",677,355,322,52.4
75620134666,"Kemmental",931,487,444,52.3
75620134671,"Kreuzlingen",4971,1800,3171,36.2
75620134681,"Langrickenbach",504,273,231,54.2
75620134683,"Lengwil",582,259,323,44.5
75620134691,"Münsterlingen",1035,401,634,38.7
75620134696,"Tägerwilen",1296,472,824,36.4
75620134701,"Wäldi",423,245,178,57.9
75620154711,"Affeltrangen",1022,612,410,59.9
75620144716,"Bettwiesen",444,251,193,56.5
75620144721,"Bichelsee-Balterswil",1171,611,560,52.2
75620144723,"Braunau",347,220,127,63.4
75620144724,"Eschlikon",1839,898,941,48.8
75620144726,"Fischingen",1174,703,471,59.9
75620144741,"Lommis",522,320,202,61.3
75620144746,"Münchwilen (TG)",1846,880,966,47.7
75620144751,"Rickenbach (TG)",820,442,378,53.9
75620154756,"Schönholzerswilen",367,233,134,63.5
75620144761,"Sirnach",2677,1344,1333,50.2
75620144776,"Tobel-Tägerschen",570,334,236,58.6
75620144781,"Wängi",1877,950,927,50.6
75620144786,"Wilen (TG)",1033,468,565,45.3
75620154791,"Wuppenau",497,270,227,54.3
75620124801,"Berlingen",360,125,235,34.7
75620124806,"Eschenz",721,331,390,45.9
75620124811,"Herdern",497,256,241,51.5
75620124816,"Homburg",662,367,295,55.4
75620124821,"Hüttwilen",800,361,439,45.1
75620124826,"Mammern",241,98,143,40.7
75620124831,"Müllheim",1067,532,535,49.9
75620124841,"Pfyn",802,470,332,58.6
75620134846,"Raperswilen",179,131,48,73.2
75620134851,"Salenstein",525,226,299,43
75620124864,"Steckborn",1400,530,870,37.9
75620124871,"Wagenhausen",641,370,271,57.7
75620154881,"Amlikon-Bissegg",597,365,232,61.1
75620154891,"Berg (TG)",1376,701,675,50.9
75620154901,"Birwinken",603,321,282,53.2
75620154911,"Bürglen (TG)",1253,698,555,55.7
75620154921,"Bussnang",935,556,379,59.5
75620154941,"Märstetten",1208,590,618,48.8
75620154946,"Weinfelden",4562,1860,2702,40.8
75620154951,"Wigoltingen",927,464,463,50.1
75621015001,"Arbedo-Castione",1957,1185,772,60.6
75621015002,"Bellinzona",6748,3564,3184,52.8
75621015003,"Cadenazzo",853,583,270,68.3
75621015004,"Camorino",1337,808,529,60.4
75621015005,"Giubiasco",3417,2030,1387,59.4
75621015006,"Gnosca",380,239,141,62.9
75621015007,"Gorduno",379,224,155,59.1
75621015008,"Gudo",388,259,129,66.8
75621015009,"Isone",225,188,37,83.6
75621015010,"Lumino",759,486,273,64
75621015012,"Moleno",69,44,25,63.8
75621015013,"Monte Carasso",1242,783,459,63
75621015014,"Pianezzo",357,217,140,60.8
75621015015,"Preonzo",332,205,127,61.7
75621015017,"Sant'Antonino",1019,701,318,68.8
75621015018,"Sant'Antonio",137,75,62,54.7
75621015019,"Sementina",1371,825,546,60.2
75621025048,"Acquarossa",904,580,324,64.2
75621025049,"Blenio",978,694,284,71
75621025050,"Serravalle",1205,843,362,70
75621035061,"Airolo",843,586,257,69.5
75621035063,"Bedretto",83,51,32,61.4
75621035064,"Bodio",287,172,115,59.9
75621035071,"Dalpe",134,84,50,62.7
75621035072,"Faido",1541,976,565,63.3
75621035073,"Giornico",400,270,130,67.5
75621035076,"Personico",181,104,77,57.5
75621035077,"Pollegio",289,194,95,67.1
75621035078,"Prato (Leventina)",223,124,99,55.6
75621035079,"Quinto",538,366,172,68
75621035081,"Sobrio",45,35,10,77.8
75621045091,"Ascona",2316,1352,964,58.4
75621045095,"Brione (Verzasca)",101,67,34,66.3
75621045096,"Brione sopra Minusio",265,146,119,55.1
75621045097,"Brissago",890,537,353,60.3
75621045102,"Corippo",10,5,5,50
75621045105,"Frasco",60,46,14,76.7
75621045108,"Gordola",2096,1300,796,62
75621045109,"Gresso",34,29,5,85.3
75621045112,"Lavertezzo",564,368,196,65.2
75621045113,"Locarno",5362,2963,2399,55.3
75621045115,"Losone",2837,1746,1091,61.5
75621045117,"Mergoscia",131,74,57,56.5
75621045118,"Minusio",3248,1719,1529,52.9
75621045119,"Mosogno",31,19,12,61.3
75621045120,"Muralto",1178,666,512,56.5
75621045121,"Orselina",391,192,199,49.1
75621045125,"Ronco sopra Ascona",315,169,146,53.7
75621045129,"Sonogno",52,28,24,53.8
75621045131,"Tenero-Contra",1230,724,506,58.9
75621045132,"Vergeletto",51,30,21,58.8
75621045135,"Vogorno",151,97,54,64.2
75621045136,"Onsernone",161,85,76,52.8
75621045137,"Isorno",161,61,100,37.9
75621045138,"Cugnasco-Gerra",1377,831,546,60.3
75621055141,"Agno",1579,1012,567,64.1
75621055143,"Aranno",156,81,75,51.9
75621055144,"Arogno",524,316,208,60.3
75621055146,"Astano",170,78,92,45.9
75621055148,"Bedano",758,474,284,62.5
75621055149,"Bedigliora",318,176,142,55.3
75621055151,"Bioggio",1285,781,504,60.8
75621055154,"Bissone",326,200,126,61.3
75621055160,"Brusino Arsizio",268,143,125,53.4
75621055161,"Cademario",355,211,144,59.4
75621055162,"Cadempino",639,404,235,63.2
75621055167,"Canobbio",915,552,363,60.3
75621055171,"Caslano",1714,1004,710,58.6
75621055176,"Comano",1139,602,537,52.9
75621055178,"Croglio",407,256,151,62.9
75621055180,"Cureglia",701,354,347,50.5
75621055181,"Curio",328,190,138,57.9
75621055186,"Grancia",179,116,63,64.8
75621055187,"Gravesano",584,376,208,64.4
75621055189,"Lamone",626,382,244,61
75621055192,"Lugano",21549,12451,9098,57.8
75621055193,"Magliaso",669,432,237,64.6
75621055194,"Manno",668,389,279,58.2
75621055195,"Maroggia",247,158,89,64
75621055196,"Massagno",2010,926,1084,46.1
75621055197,"Melano",577,363,214,62.9
75621055198,"Melide",683,360,323,52.7
75621055199,"Mezzovico-Vira",666,477,189,71.6
75621055200,"Miglieglia",117,71,46,60.7
75621055202,"Monteggio",414,276,138,66.7
75621055203,"Morcote",267,167,100,62.5
75621055205,"Muzzano",427,235,192,55
75621055206,"Neggio",189,95,94,50.3
75621055207,"Novaggio",411,215,196,52.3
75621055208,"Origlio",723,408,315,56.4
75621055210,"Paradiso",915,575,340,62.8
75621055212,"Ponte Capriasca",918,526,392,57.3
75621055213,"Ponte Tresa",330,218,112,66.1
75621055214,"Porza",751,433,318,57.7
75621055216,"Pura",659,397,262,60.2
75621055219,"Rovio",407,256,151,62.9
75621055221,"Savosa",852,495,357,58.1
75621055222,"Sessa",364,206,158,56.6
75621055225,"Sorengo",725,362,363,49.9
75621055226,"Capriasca",3293,1786,1507,54.2
75621055227,"Torricella-Taverne",1214,748,466,61.6
75621055230,"Vernate",267,140,127,52.4
75621055231,"Vezia",820,471,349,57.4
75621055233,"Vico Morcote",119,65,54,54.6
75621055236,"Collina d'Oro",2006,1070,936,53.3
75621055237,"Alto Malcantone",756,419,337,55.4
75621055238,"Monteceneri",1983,1342,641,67.7
75621065242,"Balerna",1523,917,606,60.2
75621065249,"Castel San Pietro",1234,739,495,59.9
75621065250,"Chiasso",2704,1718,986,63.5
75621065251,"Coldrerio",1443,910,533,63.1
75621065254,"Mendrisio",7159,4267,2892,59.6
75621065257,"Morbio Inferiore",2106,1299,807,61.7
75621065260,"Novazzano",1315,875,440,66.5
75621065263,"Riva San Vitale",1373,886,487,64.5
75621065266,"Stabio",2073,1297,776,62.6
75621065268,"Vacallo",1467,896,571,61.1
75621065269,"Breggia",1138,681,457,59.8
75621075281,"Biasca",2098,1420,678,67.7
75621075282,"Claro",1292,796,496,61.6
75621075283,"Cresciano",230,179,51,77.8
75621075284,"Iragna",234,159,75,67.9
75621075285,"Lodrino",728,469,259,64.4
75621075286,"Osogna",392,259,133,66.1
75621085304,"Bosco/Gurin",26,12,14,46.2
75621085307,"Campo (Vallemaggia)",34,15,19,44.1
75621085309,"Cerentino",25,15,10,60
75621085310,"Cevio",589,352,237,59.8
75621085315,"Linescio",24,17,7,70.8
75621085317,"Maggia",1266,778,488,61.5
75621085323,"Lavizzara",306,219,87,71.6
75621085324,"Avegno Gordevio",798,448,350,56.1
75621045396,"Terre di Pedemonte",1420,701,719,49.4
75621045397,"Centovalli",656,399,257,60.8
75621045398,"Gambarogno",2365,1405,960,59.4
75622215401,"Aigle",2863,1009,1854,35.2
75622215402,"Bex",2518,961,1557,38.2
75622215403,"Chessel",177,84,93,47.5
75622215404,"Corbeyrier",251,117,134,46.6
75622215405,"Gryon",482,202,280,41.9
75622215406,"Lavey-Morcles",356,164,192,46.1
75622215407,"Leysin",887,294,593,33.1
75622215408,"Noville",385,160,225,41.6
75622215409,"Ollon",2634,979,1655,37.2
75622215410,"Ormont-Dessous",509,244,265,47.9
75622215411,"Ormont-Dessus",690,304,386,44.1
75622215412,"Rennaz",262,116,146,44.3
75622215413,"Roche (VD)",457,215,242,47
75622215414,"Villeneuve (VD)",1511,590,921,39
75622215415,"Yvorne",516,185,331,35.9
75622275421,"Apples",616,178,438,28.9
75622275422,"Aubonne",1138,323,815,28.4
75622275423,"Ballens",255,96,159,37.6
75622275424,"Berolle",132,39,93,29.5
75622275425,"Bière",604,288,316,47.7
75622275426,"Bougy-Villars",186,87,99,46.8
75622275427,"Féchy",349,113,236,32.4
75622275428,"Gimel",690,288,402,41.7
75622285429,"Longirod",199,73,126,36.7
75622285430,"Marchissy",197,62,135,31.5
75622275431,"Mollens (VD)",136,62,74,45.6
75622275432,"Montherod",183,73,110,39.9
75622285434,"Saint-George",362,105,257,29
75622275435,"Saint-Livres",299,106,193,35.5
75622275436,"Saint-Oyens",164,68,96,41.5
75622275437,"Saubraz",124,56,68,45.2
75622225451,"Avenches",1294,573,721,44.3
75622225456,"Cudrefin",672,293,379,43.6
75622225458,"Faoug",327,123,204,37.6
75622225464,"Vully-les-Lacs",1327,556,771,41.9
75622235471,"Bettens",220,92,128,41.8
75622235472,"Bournens",151,53,98,35.1
75622235473,"Boussens",420,172,248,41
75622275474,"La Chaux (Cossonay)",222,81,141,36.5
75622275475,"Chavannes-le-Veyron",72,33,39,45.8
75622275476,"Chevilly",129,36,93,27.9
75622275477,"Cossonay",1356,448,908,33
75622275478,"Cottens (VD)",228,76,152,33.3
75622275479,"Cuarnens",246,80,166,32.5
75622235480,"Daillens",406,149,257,36.7
75622275481,"Dizy",121,42,79,34.7
75622275482,"Eclépens",455,185,270,40.7
75622275483,"Ferreyres",157,46,111,29.3
75622275484,"Gollion",381,144,237,37.8
75622275485,"Grancy",197,60,137,30.5
75622275486,"L'Isle",493,175,318,35.5
75622235487,"Lussery-Villars",179,74,105,41.3
75622275488,"Mauraz",30,16,14,53.3
75622235489,"Mex (VD)",288,125,163,43.4
75622275490,"Moiry",162,47,115,29
75622275491,"Mont-la-Ville",191,80,111,41.9
75622275492,"Montricher",492,191,301,38.8
75622275493,"Orny",145,44,101,30.3
75622275494,"Pampigny",506,194,312,38.3
75622235495,"Penthalaz",1130,420,710,37.2
75622235496,"Penthaz",619,242,377,39.1
75622275497,"Pompaples",269,93,176,34.6
75622275498,"La Sarraz",840,268,572,31.9
75622275499,"Senarclens",205,70,135,34.1
75622275500,"Sévery",119,47,72,39.5
75622235501,"Sullens",450,179,271,39.8
75622235503,"Vufflens-la-Ville",578,207,371,35.8
75622235511,"Assens",512,177,335,34.6
75622235512,"Bercher",481,178,303,37
75622235513,"Bioley-Orjulaz",213,97,116,45.5
75622235514,"Bottens",524,222,302,42.4
75622235515,"Bretigny-sur-Morrens",324,122,202,37.7
75622235516,"Cugy (VD)",1050,333,717,31.7
75622235518,"Echallens",2087,724,1363,34.7
75622235520,"Essertines-sur-Yverdon",400,163,237,40.8
75622235521,"Etagnières",456,156,300,34.2
75622235522,"Fey",307,105,202,34.2
75622235523,"Froideville",1043,438,605,42
75622235527,"Morrens (VD)",501,195,306,38.9
75622235529,"Oulens-sous-Echallens",274,99,175,36.1
75622235530,"Pailly",242,125,117,51.7
75622235531,"Penthéréaz",188,78,110,41.5
75622235533,"Poliez-Pittet",355,148,207,41.7
75622235534,"Rueyres",124,58,66,46.8
75622235535,"Saint-Barthélemy (VD)",393,161,232,41
75622235537,"Villars-le-Terroir",535,228,307,42.6
75622235539,"Vuarrens",330,129,201,39.1
75622235540,"Montilliez",757,333,424,44
75622235541,"Goumoëns",476,198,278,41.6
75622245551,"Bonvillars",254,106,148,41.7
75622245552,"Bullet",339,172,167,50.7
75622245553,"Champagne",407,145,262,35.6
75622245554,"Concise",432,180,252,41.7
75622245555,"Corcelles-près-Concise",166,40,126,24.1
75622245556,"Fiez",186,55,131,29.6
75622245557,"Fontaines-sur-Grandson",84,41,43,48.8
75622245559,"Giez",195,64,131,32.8
75622245560,"Grandevent",99,39,60,39.4
75622245561,"Grandson",1313,421,892,32.1
75622245562,"Mauborget",63,38,25,60.3
75622245563,"Mutrux",80,38,42,47.5
75622245564,"Novalles",58,23,35,39.7
75622245565,"Onnens (VD)",194,67,127,34.5
75622245566,"Provence",188,91,97,48.4
75622245568,"Sainte-Croix",1827,726,1101,39.7
75622245571,"Tévenon",369,146,223,39.6
75622265581,"Belmont-sur-Lausanne",1417,404,1013,28.5
75622255582,"Cheseaux-sur-Lausanne",1618,508,1110,31.4
75622295583,"Crissier",1960,719,1241,36.7
75622255584,"Epalinges",3435,976,2459,28.4
75622255585,"Jouxtens-Mézery",662,175,487,26.4
75622255586,"Lausanne",36298,8898,27400,24.5
75622255587,"Le Mont-sur-Lausanne",2823,816,2007,28.9
75622265588,"Paudex",570,178,392,31.2
75622295589,"Prilly",3188,1046,2142,32.8
75622265590,"Pully",6716,1797,4919,26.8
75622295591,"Renens (VD)",4319,1332,2987,30.8
75622255592,"Romanel-sur-Lausanne",1226,457,769,37.3
75622265601,"Chexbres",897,296,601,33
75622265604,"Forel (Lavaux)",879,327,552,37.2
75622265606,"Lutry",4014,1105,2909,27.5
75622265607,"Puidoux",1030,368,662,35.7
75622265609,"Rivaz",181,44,137,24.3
75622265610,"Saint-Saphorin (Lavaux)",171,42,129,24.6
75622265611,"Savigny",1405,460,945,32.7
75622265613,"Bourg-en-Lavaux",2493,609,1884,24.4
75622275621,"Aclens",199,70,129,35.2
75622275622,"Bremblens",217,73,144,33.6
75622275623,"Buchillon",306,101,205,33
75622295624,"Bussigny",2606,924,1682,35.5
75622275625,"Bussy-Chardonney",193,48,145,24.9
75622295627,"Chavannes-près-Renens",1494,523,971,35
75622275628,"Chigny",131,32,99,24.4
75622275629,"Clarmont",77,31,46,40.3
75622275631,"Denens",341,96,245,28.2
75622275632,"Denges",582,169,413,29
75622275633,"Echandens",1082,363,719,33.5
75622275634,"Echichens",1125,319,806,28.4
75622295635,"Ecublens (VD)",3111,1103,2008,35.5
75622275636,"Etoy",988,268,720,27.1
75622275637,"Lavigny",368,105,263,28.5
75622275638,"Lonay",989,303,686,30.6
75622275639,"Lully (VD)",337,77,260,22.8
75622275640,"Lussy-sur-Morges",291,61,230,21
75622275642,"Morges",5125,1504,3621,29.3
75622275643,"Préverenges",1761,568,1193,32.3
75622275644,"Reverolle",171,56,115,32.7
75622275645,"Romanel-sur-Morges",233,61,172,26.2
75622275646,"Saint-Prex",1729,534,1195,30.9
75622295648,"Saint-Sulpice (VD)",1305,418,887,32
75622275649,"Tolochenaz",656,207,449,31.6
75622275650,"Vaux-sur-Morges",89,18,71,20.2
75622295651,"Villars-Sainte-Croix",311,125,186,40.2
75622275652,"Villars-sous-Yens",274,79,195,28.8
75622275653,"Vufflens-le-Château",362,114,248,31.5
75622275654,"Vullierens",220,73,147,33.2
75622275655,"Yens",610,191,419,31.3
75622235661,"Boulens",165,75,90,45.5
75622225662,"Brenles",82,32,50,39
75622225663,"Bussy-sur-Moudon",110,61,49,55.5
75622225665,"Chavannes-sur-Moudon",122,67,55,54.9
75622225666,"Chesalles-sur-Moudon",75,29,46,38.7
75622225668,"Cremin",24,12,12,50
75622225669,"Curtilles",120,38,82,31.7
75622225671,"Dompierre (VD)",117,57,60,48.7
75622225672,"Forel-sur-Lucens",88,36,52,40.9
75622225673,"Hermenches",159,82,77,51.6
75622225674,"Lovatens",78,33,45,42.3
75622225675,"Lucens",808,353,455,43.7
75622225678,"Moudon",1389,583,806,42
75622235680,"Ogens",119,62,57,52.1
75622225683,"Prévonloup",71,30,41,42.3
75622225684,"Rossenges",37,16,21,43.2
75622225686,"Sarzens",46,10,36,21.7
75622225688,"Syens",55,30,25,54.5
75622225690,"Villars-le-Comte",77,47,30,61
75622225692,"Vucherens",254,99,155,39
75622235693,"Montanaire",1118,472,646,42.2
75622285701,"Arnex-sur-Nyon",95,28,67,29.5
75622285702,"Arzier-Le Muids",911,330,581,36.2
75622285703,"Bassins",552,196,356,35.5
75622285704,"Begnins",692,245,447,35.4
75622285705,"Bogis-Bossey",263,82,181,31.2
75622285706,"Borex",384,124,260,32.3
75622285707,"Chavannes-de-Bogis",389,152,237,39.1
75622285708,"Chavannes-des-Bois",270,80,190,29.6
75622285709,"Chéserex",516,169,347,32.8
75622285710,"Coinsins",179,68,111,38
75622285711,"Commugny",903,314,589,34.8
75622285712,"Coppet",936,313,623,33.4
75622285713,"Crans-près-Céligny",792,238,554,30.1
75622285714,"Crassier",433,135,298,31.2
75622285715,"Duillier",398,122,276,30.7
75622285716,"Eysins",475,159,316,33.5
75622285717,"Founex",993,293,700,29.5
75622285718,"Genolier",734,236,498,32.2
75622285719,"Gingins",481,164,317,34.1
75622285720,"Givrins",428,151,277,35.3
75622285721,"Gland",3729,1247,2482,33.4
75622285722,"Grens",159,44,115,27.7
75622285723,"Mies",559,171,388,30.6
75622285724,"Nyon",6015,1851,4164,30.8
75622285725,"Prangins",1499,421,1078,28.1
75622285726,"La Rippe",407,120,287,29.5
75622285727,"Saint-Cergue",746,316,430,42.4
75622285728,"Signy-Avenex",193,57,136,29.5
75622285729,"Tannay",520,153,367,29.4
75622285730,"Trélex",564,165,399,29.3
75622285731,"Le Vaud",500,155,345,31
75622285732,"Vich",292,92,200,31.5
75622245741,"L'Abergement",131,63,68,48.1
75622245742,"Agiez",147,63,84,42.9
75622245743,"Arnex-sur-Orbe",283,111,172,39.2
75622245744,"Ballaigues",480,212,268,44.2
75622245745,"Baulmes",483,178,305,36.9
75622245746,"Bavois",390,177,213,45.4
75622245747,"Bofflens",105,38,67,36.2
75622245748,"Bretonnières",130,49,81,37.7
75622245749,"Chavornay",1335,568,767,42.5
75622245750,"Les Clées",102,28,74,27.5
75622245751,"Corcelles-sur-Chavornay",170,61,109,35.9
75622245752,"Croy",146,49,97,33.6
75622245754,"Juriens",178,58,120,32.6
75622245755,"Lignerolle",178,92,86,51.7
75622245756,"Montcherand",223,101,122,45.3
75622245757,"Orbe",2055,795,1260,38.7
75622245758,"La Praz",85,41,44,48.2
75622245759,"Premier",131,41,90,31.3
75622245760,"Rances",236,114,122,48.3
75622245761,"Romainmôtier-Envy",235,82,153,34.9
75622245762,"Sergey",75,34,41,45.3
75622245763,"Valeyres-sous-Rances",257,114,143,44.4
75622245764,"Vallorbe",1286,560,726,43.5
75622245765,"Vaulion",243,115,128,47.3
75622245766,"Vuiteboeuf",200,80,120,40
75622225782,"Carrouge (VD)",438,153,285,34.9
75622225785,"Corcelles-le-Jorat",224,94,130,42
75622265788,"Essertes",146,88,58,60.3
75622265789,"Ferlens (VD)",181,65,116,35.9
75622265790,"Maracon",224,92,132,41.1
75622265791,"Mézières (VD)",553,178,375,32.2
75622265792,"Montpreveyres",235,78,157,33.2
75622225798,"Ropraz",184,71,113,38.6
75622265799,"Servion",811,276,535,34
75622225803,"Vulliens",243,86,157,35.4
75622235804,"Jorat-Menthue",656,270,386,41.2
75622265805,"Oron",1983,733,1250,37
75622225812,"Champtauroz",56,21,35,37.5
75622225813,"Chevroux",226,120,106,53.1
75622225816,"Corcelles-près-Payerne",846,420,426,49.6
75622225817,"Grandcour",422,164,258,38.9
75622225819,"Henniez",108,53,55,49.1
75622225821,"Missy",167,60,107,35.9
75622225822,"Payerne",2737,1285,1452,46.9
75622225827,"Trey",124,52,72,41.9
75622225828,"Treytorrens (Payerne)",63,30,33,47.6
75622225830,"Villarzel",199,93,106,46.7
75622225831,"Valbroye",1164,538,626,46.2
75622305841,"Château-d'Oex",1197,482,715,40.3
75622305842,"Rossinière",234,93,141,39.7
75622305843,"Rougemont",290,145,145,50
75622275851,"Allaman",168,65,103,38.7
75622285852,"Bursinel",197,68,129,34.5
75622285853,"Bursins",304,82,222,27
75622285854,"Burtigny",144,64,80,44.4
75622285855,"Dully",217,67,150,30.9
75622285856,"Essertines-sur-Rolle",265,85,180,32.1
75622285857,"Gilly",446,155,291,34.8
75622285858,"Luins",177,68,109,38.4
75622285859,"Mont-sur-Rolle",883,301,582,34.1
75622285860,"Perroy",499,184,315,36.9
75622285861,"Rolle",1580,475,1105,30.1
75622285862,"Tartegnin",110,39,71,35.5
75622285863,"Vinzel",142,38,104,26.8
75622245871,"L'Abbaye",639,215,424,33.6
75622245872,"Le Chenit",1675,651,1024,38.9
75622245873,"Le Lieu",383,140,243,36.6
75622305881,"Blonay",2441,755,1686,30.9
75622305882,"Chardonne",1247,359,888,28.8
75622305883,"Corseaux",948,281,667,29.6
75622305884,"Corsier-sur-Vevey",1141,418,723,36.6
75622305885,"Jongny",640,207,433,32.3
75622305886,"Montreux",6513,2211,4302,33.9
75622305888,"Saint-Légier-La Chiésaz",2075,595,1480,28.7
75622305889,"La Tour-de-Peilz",4185,1274,2911,30.4
75622305890,"Vevey",5175,1388,3787,26.8
75622305891,"Veytaux",314,105,209,33.4
75622245902,"Belmont-sur-Yverdon",171,65,106,38
75622245903,"Bioley-Magnoux",128,59,69,46.1
75622245904,"Chamblon",260,87,173,33.5
75622245905,"Champvent",253,95,158,37.5
75622245907,"Chavannes-le-Chêne",127,67,60,52.8
75622245908,"Chêne-Pâquier",63,19,44,30.2
75622245909,"Cheseaux-Noréaz",333,110,223,33
75622245910,"Cronay",206,69,137,33.5
75622245911,"Cuarny",102,65,37,63.7
75622245912,"Démoret",84,43,41,51.2
75622245913,"Donneloye",374,159,215,42.5
75622245914,"Ependes (VD)",155,74,81,47.7
75622245915,"Essert-Pittet",71,36,35,50.7
75622245919,"Mathod",286,114,172,39.9
75622245921,"Molondin",115,60,55,52.2
75622245922,"Montagny-près-Yverdon",321,123,198,38.3
75622235923,"Oppens",73,26,47,35.6
75622245924,"Orges",122,50,72,41
75622245925,"Orzens",113,48,65,42.5
75622245926,"Pomy",338,133,205,39.3
75622245928,"Rovray",90,41,49,45.6
75622245929,"Suchy",244,84,160,34.4
75622245930,"Suscévaz",110,48,62,43.6
75622245931,"Treycovagnes",229,84,145,36.7
75622245932,"Ursins",110,52,58,47.3
75622245933,"Valeyres-sous-Montagny",276,107,169,38.8
75622245934,"Valeyres-sous-Ursins",117,54,63,46.2
75622245935,"Villars-Epeney",61,27,34,44.3
75622245937,"Vugelles-La Mothe",54,30,24,55.6
75622245938,"Yverdon-les-Bains",8448,2994,5454,35.4
75622245939,"Yvonand",1282,495,787,38.6
75623016002,"Brig-Glis",5611,2663,2948,47.5
75623016004,"Eggerberg",184,114,70,62
75623016007,"Naters",4584,2411,2173,52.6
75623016008,"Ried-Brig",1040,517,523,49.7
75623016009,"Simplon",207,100,107,48.3
75623016010,"Termen",464,226,238,48.7
75623016011,"Zwischbergen",43,38,5,88.4
75623026021,"Ardon",965,443,522,45.9
75623026022,"Chamoson",1583,728,855,46
75623026023,"Conthey",3168,1479,1689,46.7
75623026024,"Nendaz",2645,1156,1489,43.7
75623026025,"Vétroz",2138,990,1148,46.3
75623036031,"Bagnes",2474,934,1540,37.8
75623036032,"Bourg-Saint-Pierre",95,43,52,45.3
75623036033,"Liddes",346,160,186,46.2
75623036034,"Orsières",1452,643,809,44.3
75623036035,"Sembrancher",383,200,183,52.2
75623036036,"Vollèges",783,275,508,35.1
75623046052,"Bellwald",199,87,112,43.7
75623046054,"Binn",62,19,43,30.6
75623046055,"Blitzingen",38,19,19,50
75623046056,"Ernen",238,116,122,48.7
75623046057,"Fiesch",428,196,232,45.8
75623046058,"Fieschertal",157,84,73,53.5
75623046061,"Lax",133,53,80,39.8
75623046064,"Niederwald",30,9,21,30
75623046073,"Grafschaft",113,59,54,52.2
75623046074,"Münster-Geschinen",212,105,107,49.5
75623046075,"Reckingen-Gluringen",228,101,127,44.3
75623046076,"Obergoms",305,159,146,52.1
75623056081,"Les Agettes",158,64,94,40.5
75623056082,"Ayent",1811,733,1078,40.5
75623056083,"Evolène",911,431,480,47.3
75623056084,"Hérémence",801,373,428,46.6
75623056087,"Saint-Martin (VS)",493,205,288,41.6
75623056089,"Vex",772,325,447,42.1
75623056090,"Mont-Noble",520,210,310,40.4
75623066101,"Agarn",376,198,178,52.7
75623066102,"Albinen",146,76,70,52.1
75623066104,"Ergisch",129,80,49,62
75623066109,"Inden",51,23,28,45.1
75623066110,"Leuk",1924,943,981,49
75623066111,"Leukerbad",478,246,232,51.5
75623066112,"Oberems",50,26,24,52
75623066113,"Salgesch",724,406,318,56.1
75623066116,"Varen",333,173,160,52
75623066117,"Guttet-Feschel",211,130,81,61.6
75623066118,"Gampel-Bratsch",1013,554,459,54.7
75623066119,"Turtmann-Unterems",582,288,294,49.5
75623076131,"Bovernier",378,178,200,47.1
75623076132,"Charrat",599,247,352,41.2
75623076133,"Fully",3432,1434,1998,41.8
75623076134,"Isérables",385,245,140,63.6
75623076135,"Leytron",1384,711,673,51.4
75623076136,"Martigny",6077,2292,3785,37.7
75623076137,"Martigny-Combe",972,386,586,39.7
75623076139,"Riddes",1097,571,526,52.1
75623076140,"Saillon",961,428,533,44.5
75623076141,"Saxon",1762,970,792,55.1
75623076142,"Trient",76,30,46,39.5
75623086151,"Champéry",523,231,292,44.2
75623086152,"Collombey-Muraz",2802,1296,1506,46.3
75623086153,"Monthey",5660,2411,3249,42.6
75623086154,"Port-Valais",1212,599,613,49.4
75623086155,"Saint-Gingolph",332,142,190,42.8
75623086156,"Troistorrents",1940,1005,935,51.8
75623086157,"Val-d'Illiez",803,462,341,57.5
75623086158,"Vionnaz",968,451,517,46.6
75623086159,"Vouvry",1291,557,734,43.1
75623096172,"Bister",20,14,6,70
75623096173,"Bitsch",436,201,235,46.1
75623096177,"Grengiols",166,84,82,50.6
75623096181,"Riederalp",252,116,136,46
75623096191,"Ausserberg",364,213,151,58.5
75623096192,"Blatten",169,86,83,50.9
75623096193,"Bürchen",379,173,206,45.6
75623096194,"Eischoll",256,134,122,52.3
75623096195,"Ferden",144,77,67,53.5
75623096197,"Kippel",227,74,153,32.6
75623096198,"Niedergesteln",368,195,173,53
75623096199,"Raron",865,422,443,48.8
75623096201,"Unterbäch",248,133,115,53.6
75623096202,"Wiler (Lötschen)",291,136,155,46.7
75623096203,"Mörel-Filet",342,161,181,47.1
75623096204,"Steg-Hohtenn",789,399,390,50.6
75623096205,"Bettmeralp",192,82,110,42.7
75623106211,"Collonges",287,130,157,45.3
75623106212,"Dorénaz",374,159,215,42.5
75623106213,"Evionnaz",491,196,295,39.9
75623106214,"Finhaut",153,51,102,33.3
75623106215,"Massongex",705,305,400,43.3
75623106217,"Saint-Maurice",1572,576,996,36.6
75623106218,"Salvan",631,237,394,37.6
75623106219,"Vernayaz",683,306,377,44.8
75623106220,"Vérossaz",345,135,210,39.1
75623116232,"Chalais",1418,602,816,42.5
75623116234,"Chermignon",1304,541,763,41.5
75623116235,"Chippis",489,215,274,44
75623116238,"Grône",941,451,490,47.9
75623116239,"Icogne",243,98,145,40.3
75623116240,"Lens",1527,688,839,45.1
75623116241,"Miège",564,213,351,37.8
75623116242,"Mollens (VS)",372,152,220,40.9
75623116243,"Montana",888,429,459,48.3
75623116244,"Randogne",982,433,549,44.1
75623116246,"Saint-Léonard",1037,491,546,47.3
75623116248,"Sierre",5777,2471,3306,42.8
75623116249,"Venthône",620,228,392,36.8
75623116250,"Veyras",823,331,492,40.2
75623116252,"Anniviers",1230,555,675,45.1
75623126261,"Arbaz",576,242,334,42
75623126263,"Grimisuat",1471,540,931,36.7
75623126265,"Savièse",3590,1726,1864,48.1
75623126266,"Sion",12425,4595,7830,37
75623126267,"Veysonnaz",243,95,148,39.1
75623136281,"Baltschieder",614,343,271,55.9
75623136282,"Eisten",102,67,35,65.7
75623136283,"Embd",143,99,44,69.2
75623136285,"Grächen",539,287,252,53.2
75623136286,"Lalden",358,164,194,45.8
75623136287,"Randa",185,104,81,56.2
75623136288,"Saas-Almagell",202,84,118,41.6
75623136289,"Saas-Balen",188,115,73,61.2
75623136290,"Saas-Fee",591,204,387,34.5
75623136291,"Saas-Grund",482,308,174,63.9
75623136292,"St. Niklaus",1014,585,429,57.7
75623136293,"Stalden (VS)",613,355,258,57.9
75623136294,"Staldenried",305,153,152,50.2
75623136295,"Täsch",266,150,116,56.4
75623136296,"Törbel",249,161,88,64.7
75623136297,"Visp",3179,1552,1627,48.8
75623136298,"Visperterminen",739,290,449,39.2
75623136299,"Zeneggen",144,44,100,30.6
75623136300,"Zermatt",1714,824,890,48.1
75624016402,"Bevaix",1573,559,1014,35.5
75624016404,"Boudry",1760,628,1132,35.7
75624016407,"Corcelles-Cormondrèche",2006,567,1439,28.3
75624016408,"Cortaillod",1860,635,1225,34.1
75624016409,"Fresens",113,35,78,31
75624016410,"Gorgier",850,330,520,38.8
75624016411,"Montalchez",103,41,62,39.8
75624016412,"Peseux",1852,687,1165,37.1
75624016413,"Rochefort",590,213,377,36.1
75624016414,"Saint-Aubin-Sauges",921,291,630,31.6
75624016415,"Vaumarcus",127,51,76,40.2
75624016416,"Milvignes",3602,1176,2426,32.6
75624026421,"La Chaux-de-Fonds",11860,4004,7856,33.8
75624026422,"Les Planchettes",97,40,57,41.2
75624026423,"La Sagne",476,216,260,45.4
75624036431,"Les Brenets",496,211,285,42.5
75624036432,"La Brévine",344,176,168,51.2
75624036433,"Brot-Plamboz",136,75,61,55.1
75624036434,"Le Cerneux-Péquignot",188,103,85,54.8
75624036435,"La Chaux-du-Milieu",267,105,162,39.3
75624036436,"Le Locle",3478,1361,2117,39.1
75624036437,"Les Ponts-de-Martel",635,286,349,45
75624046451,"Cornaux",605,240,365,39.7
75624046452,"Cressier (NE)",652,215,437,33
75624046453,"Enges",147,47,100,32
75624046454,"Hauterive (NE)",1017,327,690,32.2
75624046455,"Le Landeron",1748,662,1086,37.9
75624046456,"Lignières",386,131,255,33.9
75624046458,"Neuchâtel",11248,2961,8287,26.3
75624046459,"Saint-Blaise",1372,351,1021,25.6
75624046461,"La Tène",1792,606,1186,33.8
75624056485,"Valangin",176,62,114,35.2
75624056487,"Val-de-Ruz",6947,2796,4151,40.2
75624066504,"La Côte-aux-Fées",243,114,129,46.9
75624066511,"Les Verrières",269,149,120,55.4
75624066512,"Val-de-Travers",3659,1619,2040,44.2
75625006601,"Aire-la-Ville",430,173,257,40.2
75625006602,"Anières",832,285,547,34.3
75625006603,"Avully",618,228,390,36.9
75625006604,"Avusy",590,196,394,33.2
75625006605,"Bardonnex",886,303,583,34.2
75625006606,"Bellevue",860,305,555,35.5
75625006607,"Bernex",3697,1245,2452,33.7
75625006608,"Carouge (GE)",5828,1883,3945,32.3
75625006609,"Cartigny",378,108,270,28.6
75625006610,"Céligny",229,82,147,35.8
75625006611,"Chancy",454,184,270,40.5
75625006612,"Chêne-Bougeries",3590,1190,2400,33.1
75625006613,"Chêne-Bourg",2382,829,1553,34.8
75625006614,"Choulex",431,142,289,32.9
75625006615,"Collex-Bossy",542,185,357,34.1
75625006616,"Collonge-Bellerive",2867,932,1935,32.5
75625006617,"Cologny",1672,604,1068,36.1
75625006618,"Confignon",1774,519,1255,29.3
75625006619,"Corsier (GE)",727,258,469,35.5
75625006620,"Dardagny",525,190,335,36.2
75625006621,"Genève",46124,15273,30851,33.1
75625006622,"Genthod",819,283,536,34.6
75625006623,"Le Grand-Saconnex",2757,1034,1723,37.5
75625006624,"Gy",212,66,146,31.1
75625006625,"Hermance",358,99,259,27.7
75625006626,"Jussy",515,214,301,41.6
75625006627,"Laconnex",296,89,207,30.1
75625006628,"Lancy",8114,3252,4862,40.1
75625006629,"Meinier",770,268,502,34.8
75625006630,"Meyrin",5107,2201,2906,43.1
75625006631,"Onex",4888,2090,2798,42.8
75625006632,"Perly-Certoux",966,426,540,44.1
75625006633,"Plan-les-Ouates",3458,1162,2296,33.6
75625006634,"Pregny-Chambésy",862,262,600,30.4
75625006635,"Presinge",260,72,188,27.7
75625006636,"Puplinge",805,281,524,34.9
75625006637,"Russin",232,87,145,37.5
75625006638,"Satigny",1296,427,869,32.9
75625006639,"Soral",302,128,174,42.4
75625006640,"Thônex",4143,1597,2546,38.5
75625006641,"Troinex",908,251,657,27.6
75625006642,"Vandoeuvres",930,331,599,35.6
75625006643,"Vernier",7171,3053,4118,42.6
75625006644,"Versoix",3070,1096,1974,35.7
75625006645,"Veyrier",3961,1262,2699,31.9
75626016702,"Boécourt",333,149,184,44.7
75626016703,"Bourrignon",151,73,78,48.3
75626016704,"Châtillon (JU)",198,74,124,37.4
75626016705,"Corban",207,75,132,36.2
75626016706,"Courchapoix",193,76,117,39.4
75626016708,"Courrendlin",929,430,499,46.3
75626016709,"Courroux",1251,569,682,45.5
75626016710,"Courtételle",919,388,531,42.2
75626016711,"Delémont",4203,1218,2985,29
75626016712,"Develier",565,254,311,45
75626016713,"Ederswiler",52,45,7,86.5
75626016715,"Mervelier",248,92,156,37.1
75626016716,"Mettembert",62,16,46,25.8
75626016718,"Movelier",166,81,85,48.8
75626016719,"Pleigne",167,82,85,49.1
75626016720,"Rebeuvelier",176,73,103,41.5
75626016721,"Rossemaison",291,108,183,37.1
75626016722,"Saulcy",101,54,47,53.5
75626016724,"Soyhières",186,80,106,43
75626016728,"Vellerat",46,22,24,47.8
75626016729,"Haute-Sorne",2540,1037,1503,40.8
75626016730,"Val Terbi",1118,439,679,39.3
75626026741,"Le Bémont (JU)",129,54,75,41.9
75626026742,"Les Bois",456,162,294,35.5
75626026743,"Les Breuleux",613,186,427,30.3
75626026744,"La Chaux-des-Breuleux",62,25,37,40.3
75626026745,"Les Enfers",78,27,51,34.6
75626026748,"Les Genevez (JU)",235,110,125,46.8
75626026750,"Lajoux (JU)",282,83,199,29.4
75626026751,"Montfaucon",260,98,162,37.7
75626026753,"Muriaux",266,122,144,45.9
75626026754,"Le Noirmont",694,270,424,38.9
75626026757,"Saignelégier",1089,321,768,29.5
75626026758,"Saint-Brais",117,56,61,47.9
75626026759,"Soubey",60,36,24,60
75626036771,"Alle",698,307,391,44
75626036773,"Beurnevésin",61,39,22,63.9
75626036774,"Boncourt",489,216,273,44.2
75626036775,"Bonfol",284,157,127,55.3
75626036778,"Bure",331,173,158,52.3
75626036781,"Coeuve",313,148,165,47.3
75626036782,"Cornol",408,189,219,46.3
75626036783,"Courchavon",140,57,83,40.7
75626036784,"Courgenay",839,384,455,45.8
75626036785,"Courtedoux",338,153,185,45.3
75626036787,"Damphreux",87,53,34,60.9
75626036789,"Fahy",139,79,60,56.8
75626036790,"Fontenais",663,227,436,34.2
75626036792,"Grandfontaine",183,81,102,44.3
75626036793,"Lugnez",76,49,27,64.5
75626036800,"Porrentruy",2538,860,1678,33.9
75626036803,"Rocourt",85,36,49,42.4
75626036806,"Vendlincourt",262,147,115,56.1
75626036807,"Basse-Allaine",456,214,242,46.9
75626036808,"Clos du Doubs",572,222,350,38.8
75626036809,"Haute-Ajoie",438,225,213,51.4
75626036810,"La Baroche",482,236,246,49
75603009030,"LU-Ausland-CH",1984,698,1286,35.2
75604009040,"UR-Ausland-CH",187,80,107,42.8
75610009100,"FR-CH de l'étranger",1702,729,973,42.8
75612009120,"BS-Ausland-CH",3184,950,2234,29.8
75616009160,"AI-Ausland-CH",131,57,74,43.5
75617009170,"SG-Ausland-CH",2692,1110,1582,41.2
75619009190,"AG-Ausland-CH",2667,965,1702,36.2
75620009200,"TG-Ausland-CH",1167,468,699,40.1
75622009220,"VD-CH de l'étranger",5985,2469,3516,41.3
75623009230,"VS-CH de l'étranger",1703,749,954,44
75625009250,"GE-CH de l'étranger",9323,3421,5902,36.7
